metro_code,metro_name,metro_pop,metro_type,variable_name,applications,loans,denials,results_def,odds_ratio,odds_ratio_rd,number_denials_compared_to_10_white,white_loans,white_denials,white_apps
35084,"Newark, NJ-PA",2164575,Metropolitan Division,Black,1011,838,173,Statistcially significant disparity,1.860004433,1.9,19,8635,494,9129
35084,"Newark, NJ-PA",2164575,Metropolitan Division,Latino,1840,1608,232,Doesn't meet level of disparity,1.428480265,1.4,14,8635,494,9129
35084,"Newark, NJ-PA",2164575,Metropolitan Division,Native American,23,22,1,Not statistcially significant,0.627483523,0.6,6,8635,494,9129
35084,"Newark, NJ-PA",2164575,Metropolitan Division,AAPI,1627,1483,144,Statistcially significant disparity,1.644145893,1.6,16,8635,494,9129
35614,"New York-Jersey City-White Plains, NY-NJ",11915488,Metropolitan Division,Black,2677,2239,438,Statistcially significant disparity,1.567522409,1.6,16,20991,1903,22894
35614,"New York-Jersey City-White Plains, NY-NJ",11915488,Metropolitan Division,Latino,5546,4818,728,Doesn't meet level of disparity,1.295846574,1.3,13,20991,1903,22894
35614,"New York-Jersey City-White Plains, NY-NJ",11915488,Metropolitan Division,Native American,69,51,18,Not enough of applications,3.003200199,3,30,20991,1903,22894
35614,"New York-Jersey City-White Plains, NY-NJ",11915488,Metropolitan Division,AAPI,10828,9655,1173,Doesn't meet level of disparity,1.189051941,1.2,12,20991,1903,22894
35154,"New Brunswick-Lakewood, NJ",2373832,Metropolitan Division,Black,636,548,88,Statistcially significant disparity,1.889602469,1.9,19,11938,857,12795
35154,"New Brunswick-Lakewood, NJ",2373832,Metropolitan Division,Latino,1632,1453,179,Statistcially significant disparity,1.512586915,1.5,15,11938,857,12795
35154,"New Brunswick-Lakewood, NJ",2373832,Metropolitan Division,Native American,33,28,5,Not statistcially significant,1.871450398,1.9,19,11938,857,12795
35154,"New Brunswick-Lakewood, NJ",2373832,Metropolitan Division,AAPI,3504,3199,305,Doesn't meet level of disparity,1.258276071,1.3,13,11938,857,12795
39100,"Poughkeepsie-Newburgh-Middletown, NY",673839,Metropolitan Statistical Area,Black,329,299,30,Not statistcially significant,1.079957227,1.1,11,2632,156,2788
39100,"Poughkeepsie-Newburgh-Middletown, NY",673839,Metropolitan Statistical Area,Latino,608,529,79,Statistcially significant disparity,1.938728824,1.9,19,2632,156,2788
39100,"Poughkeepsie-Newburgh-Middletown, NY",673839,Metropolitan Statistical Area,Native American,9,6,3,Not statistcially significant,4.737493148,4.7,47,2632,156,2788
39100,"Poughkeepsie-Newburgh-Middletown, NY",673839,Metropolitan Statistical Area,AAPI,188,161,27,Statistcially significant disparity,2.477167783,2.5,25,2632,156,2788
45940,"Trenton-Princeton, NJ",367922,Metropolitan Statistical Area,Black,154,138,16,Regression equation needs to be tweaked,1.324394995,1.3,13,1179,76,1255
45940,"Trenton-Princeton, NJ",367922,Metropolitan Statistical Area,Latino,258,219,39,Regression equation needs to be tweaked,1.626405503,1.6,16,1179,76,1255
45940,"Trenton-Princeton, NJ",367922,Metropolitan Statistical Area,Native American,4,4,0,Regression equation needs to be tweaked,6.79E-09,0,0,1179,76,1255
45940,"Trenton-Princeton, NJ",367922,Metropolitan Statistical Area,AAPI,608,560,48,Regression equation needs to be tweaked,1.20816554,1.2,12,1179,76,1255
20700,"East Stroudsburg, PA",168032,Metropolitan Statistical Area,Black,87,74,13,No meaningful results,,,,555,55,610
20700,"East Stroudsburg, PA",168032,Metropolitan Statistical Area,Latino,120,104,16,No meaningful results,,,,555,55,610
20700,"East Stroudsburg, PA",168032,Metropolitan Statistical Area,Native American,4,4,0,No meaningful results,,,,555,55,610
20700,"East Stroudsburg, PA",168032,Metropolitan Statistical Area,AAPI,31,27,4,No meaningful results,,,,555,55,610
48424,"West Palm Beach-Boca Raton-Boynton Beach, FL",1465027,Metropolitan Division,Black,1071,885,186,Statistcially significant disparity,1.512250314,1.5,15,7132,809,7941
48424,"West Palm Beach-Boca Raton-Boynton Beach, FL",1465027,Metropolitan Division,Latino,2300,2005,295,Not statistcially significant,1.064816385,1.1,11,7132,809,7941
48424,"West Palm Beach-Boca Raton-Boynton Beach, FL",1465027,Metropolitan Division,Native American,39,35,4,Not statistcially significant,1.010304388,1,10,7132,809,7941
48424,"West Palm Beach-Boca Raton-Boynton Beach, FL",1465027,Metropolitan Division,AAPI,546,468,78,Not statistcially significant,1.276821895,1.3,13,7132,809,7941
33124,"Miami-Miami Beach-Kendall, FL",2699428,Metropolitan Division,Black,618,479,139,Not statistcially significant,1.152675438,1.2,12,2286,437,2723
33124,"Miami-Miami Beach-Kendall, FL",2699428,Metropolitan Division,Latino,10728,9156,1572,Not statistcially significant,0.968221926,1,10,2286,437,2723
33124,"Miami-Miami Beach-Kendall, FL",2699428,Metropolitan Division,Native American,10,6,4,Not statistcially significant,1.089840902,1.1,11,2286,437,2723
33124,"Miami-Miami Beach-Kendall, FL",2699428,Metropolitan Division,AAPI,315,259,56,Not statistcially significant,1.187086129,1.2,12,2286,437,2723
37964,"Philadelphia, PA",2143629,Metropolitan Division,Black,1162,964,198,Statistcially significant disparity,1.951517451,2,20,6860,322,7182
37964,"Philadelphia, PA",2143629,Metropolitan Division,Latino,703,626,77,Not statistcially significant,1.332157821,1.3,13,6860,322,7182
37964,"Philadelphia, PA",2143629,Metropolitan Division,Native American,15,15,0,Not statistcially significant,3.43E-139,0,0,6860,322,7182
37964,"Philadelphia, PA",2143629,Metropolitan Division,AAPI,1679,1470,209,Doesn't meet level of disparity,1.429481208,1.4,14,6860,322,7182
12100,"Atlantic City-Hammonton, NJ",266105,Metropolitan Statistical Area,Black,56,50,6,No meaningful results,,,,994,74,1068
12100,"Atlantic City-Hammonton, NJ",266105,Metropolitan Statistical Area,Latino,151,140,11,No meaningful results,,,,994,74,1068
12100,"Atlantic City-Hammonton, NJ",266105,Metropolitan Statistical Area,Native American,4,4,0,No meaningful results,,,,994,74,1068
12100,"Atlantic City-Hammonton, NJ",266105,Metropolitan Statistical Area,AAPI,120,108,12,No meaningful results,,,,994,74,1068
35004,"Nassau County-Suffolk County, NY",2840341,Metropolitan Division,Black,999,869,130,Statistcially significant disparity,1.518148085,1.5,15,11175,788,11963
35004,"Nassau County-Suffolk County, NY",2840341,Metropolitan Division,Latino,2314,2039,275,Statistcially significant disparity,1.574993776,1.6,16,11175,788,11963
35004,"Nassau County-Suffolk County, NY",2840341,Metropolitan Division,Native American,26,24,2,Not statistcially significant,1.888356365,1.9,19,11175,788,11963
35004,"Nassau County-Suffolk County, NY",2840341,Metropolitan Division,AAPI,2842,2591,251,Doesn't meet level of disparity,1.208123003,1.2,12,11175,788,11963
47894,"Washington-Arlington-Alexandria, DC-VA-MD-WV",4901633,Metropolitan Division,Black,5407,4887,520,Statistcially significant disparity,2.172453054,2.2,22,20600,674,21274
47894,"Washington-Arlington-Alexandria, DC-VA-MD-WV",4901633,Metropolitan Division,Latino,4205,3877,328,Statistcially significant disparity,1.745780832,1.7,17,20600,674,21274
47894,"Washington-Arlington-Alexandria, DC-VA-MD-WV",4901633,Metropolitan Division,Native American,117,109,8,Not statistcially significant,1.74367644,1.7,17,20600,674,21274
47894,"Washington-Arlington-Alexandria, DC-VA-MD-WV",4901633,Metropolitan Division,AAPI,6978,6458,520,Statistcially significant disparity,2.01707021,2,20,20600,674,21274
15804,"Camden, NJ",1243605,Metropolitan Division,Black,599,518,81,Regression equation needs to be tweaked,2.174630548,2.2,22,5451,261,5712
15804,"Camden, NJ",1243605,Metropolitan Division,Latino,523,466,57,Regression equation needs to be tweaked,1.546261934,1.5,15,5451,261,5712
15804,"Camden, NJ",1243605,Metropolitan Division,Native American,5,4,1,Regression equation needs to be tweaked,1.248286557,1.2,12,5451,261,5712
15804,"Camden, NJ",1243605,Metropolitan Division,AAPI,606,553,53,Regression equation needs to be tweaked,1.321527986,1.3,13,5451,261,5712
33874,"Montgomery County-Bucks County-Chester County, PA",1970189,Metropolitan Division,Black,530,483,47,Statistcially significant disparity,1.72819336,1.7,17,12915,606,13521
33874,"Montgomery County-Bucks County-Chester County, PA",1970189,Metropolitan Division,Latino,547,503,44,Statistcially significant disparity,1.709872058,1.7,17,12915,606,13521
33874,"Montgomery County-Bucks County-Chester County, PA",1970189,Metropolitan Division,Native American,21,20,1,Not statistcially significant,0.712807334,0.7,7,12915,606,13521
33874,"Montgomery County-Bucks County-Chester County, PA",1970189,Metropolitan Division,AAPI,1809,1674,135,Statistcially significant disparity,1.611667695,1.6,16,12915,606,13521
42540,"Scranton--Wilkes-Barre, PA",555642,Metropolitan Statistical Area,Black,30,21,9,Regression equation needs to be tweaked,2.820186597,2.8,28,1766,140,1906
42540,"Scranton--Wilkes-Barre, PA",555642,Metropolitan Statistical Area,Latino,212,175,37,Regression equation needs to be tweaked,0.971169817,1,10,1766,140,1906
42540,"Scranton--Wilkes-Barre, PA",555642,Metropolitan Statistical Area,Native American,3,3,0,Regression equation needs to be tweaked,6.96E-08,0,0,1766,140,1906
42540,"Scranton--Wilkes-Barre, PA",555642,Metropolitan Statistical Area,AAPI,66,62,4,Regression equation needs to be tweaked,0.776062028,0.8,8,1766,140,1906
22744,"Fort Lauderdale-Pompano Beach-Sunrise, FL",1926205,Metropolitan Division,Black,2382,1942,440,Doesn't meet level of disparity,1.434367588,1.4,14,5600,735,6335
22744,"Fort Lauderdale-Pompano Beach-Sunrise, FL",1926205,Metropolitan Division,Latino,5392,4686,706,Not statistcially significant,1.051496374,1.1,11,5600,735,6335
22744,"Fort Lauderdale-Pompano Beach-Sunrise, FL",1926205,Metropolitan Division,Native American,28,23,5,Not statistcially significant,1.3829255,1.4,14,5600,735,6335
22744,"Fort Lauderdale-Pompano Beach-Sunrise, FL",1926205,Metropolitan Division,AAPI,779,663,116,Not statistcially significant,1.183644442,1.2,12,5600,735,6335
44300,"State College, PA",161960,Metropolitan Statistical Area,Black,12,12,0,Regression equation needs to be tweaked,7.51E-08,0,0,767,47,814
44300,"State College, PA",161960,Metropolitan Statistical Area,Latino,18,17,1,Regression equation needs to be tweaked,0.24120458,0.2,2,767,47,814
44300,"State College, PA",161960,Metropolitan Statistical Area,Native American,3,2,1,Regression equation needs to be tweaked,1.725061906,1.7,17,767,47,814
44300,"State College, PA",161960,Metropolitan Statistical Area,AAPI,58,53,5,Regression equation needs to be tweaked,1.653869516,1.7,17,767,47,814
36740,"Orlando-Kissimmee-Sanford, FL",2508970,Metropolitan Statistical Area,Black,1582,1369,213,Statistcially significant disparity,1.478437163,1.5,15,11932,951,12883
36740,"Orlando-Kissimmee-Sanford, FL",2508970,Metropolitan Statistical Area,Latino,5256,4564,692,Statistcially significant disparity,1.458779961,1.5,15,11932,951,12883
36740,"Orlando-Kissimmee-Sanford, FL",2508970,Metropolitan Statistical Area,Native American,73,59,14,Not enough of applications,2.904751084,2.9,29,11932,951,12883
36740,"Orlando-Kissimmee-Sanford, FL",2508970,Metropolitan Statistical Area,AAPI,1686,1497,189,Doesn't meet level of disparity,1.253990089,1.3,13,11932,951,12883
10900,"Allentown-Bethlehem-Easton, PA-NJ",837610,Metropolitan Statistical Area,Black,157,137,20,Statistcially significant disparity,1.786862579,1.8,18,3984,225,4209
10900,"Allentown-Bethlehem-Easton, PA-NJ",837610,Metropolitan Statistical Area,Latino,569,503,66,Not statistcially significant,1.315739915,1.3,13,3984,225,4209
10900,"Allentown-Bethlehem-Easton, PA-NJ",837610,Metropolitan Statistical Area,Native American,13,10,3,Not statistcially significant,2.243582702,2.2,22,3984,225,4209
10900,"Allentown-Bethlehem-Easton, PA-NJ",837610,Metropolitan Statistical Area,AAPI,282,255,27,Not statistcially significant,1.458549554,1.5,15,3984,225,4209
35840,"North Port-Sarasota-Bradenton, FL",803709,Metropolitan Statistical Area,Black,192,170,22,Statistcially significant disparity,1.841650466,1.8,18,7266,619,7885
35840,"North Port-Sarasota-Bradenton, FL",803709,Metropolitan Statistical Area,Latino,702,605,97,Statistcially significant disparity,1.854714478,1.9,19,7266,619,7885
35840,"North Port-Sarasota-Bradenton, FL",803709,Metropolitan Statistical Area,Native American,18,13,5,Not statistcially significant,2.6541946,2.7,27,7266,619,7885
35840,"North Port-Sarasota-Bradenton, FL",803709,Metropolitan Statistical Area,AAPI,232,206,26,Statistcially significant disparity,1.748736895,1.7,17,7266,619,7885
12580,"Baltimore-Columbia-Towson, MD",2796733,Metropolitan Statistical Area,Black,2322,2085,237,Statistcially significant disparity,2.367546295,2.4,24,13150,473,13623
12580,"Baltimore-Columbia-Towson, MD",2796733,Metropolitan Statistical Area,Latino,1018,938,80,Statistcially significant disparity,1.626490622,1.6,16,13150,473,13623
12580,"Baltimore-Columbia-Towson, MD",2796733,Metropolitan Statistical Area,Native American,54,48,6,Not statistcially significant,1.480867119,1.5,15,13150,473,13623
12580,"Baltimore-Columbia-Towson, MD",2796733,Metropolitan Statistical Area,AAPI,2187,1987,200,Statistcially significant disparity,2.318359649,2.3,23,13150,473,13623
39740,"Reading, PA",418025,Metropolitan Statistical Area,Black,60,53,7,Regression equation needs to be tweaked,1.968031246,2,20,1831,82,1913
39740,"Reading, PA",418025,Metropolitan Statistical Area,Latino,281,243,38,Regression equation needs to be tweaked,1.443655318,1.4,14,1831,82,1913
39740,"Reading, PA",418025,Metropolitan Statistical Area,Native American,2,2,0,Regression equation needs to be tweaked,3.02E-08,0,0,1831,82,1913
39740,"Reading, PA",418025,Metropolitan Statistical Area,AAPI,51,49,2,Regression equation needs to be tweaked,0.58725429,0.6,6,1831,82,1913
49620,"York-Hanover, PA",445565,Metropolitan Statistical Area,Black,101,82,19,Regression equation needs to be tweaked,4.611601837,4.6,46,2526,118,2644
49620,"York-Hanover, PA",445565,Metropolitan Statistical Area,Latino,112,96,16,Regression equation needs to be tweaked,2.559298236,2.6,26,2526,118,2644
49620,"York-Hanover, PA",445565,Metropolitan Statistical Area,Native American,7,7,0,Regression equation needs to be tweaked,1.30E-11,0,0,2526,118,2644
49620,"York-Hanover, PA",445565,Metropolitan Statistical Area,AAPI,69,66,3,Regression equation needs to be tweaked,0.564113102,0.6,6,2526,118,2644
38300,"Pittsburgh, PA",2331447,Metropolitan Statistical Area,Black,394,350,44,Not statistcially significant,1.11756818,1.1,11,12757,649,13406
38300,"Pittsburgh, PA",2331447,Metropolitan Statistical Area,Latino,216,203,13,Not statistcially significant,0.990554105,1,10,12757,649,13406
38300,"Pittsburgh, PA",2331447,Metropolitan Statistical Area,Native American,23,22,1,Not statistcially significant,0.404522912,0.4,4,12757,649,13406
38300,"Pittsburgh, PA",2331447,Metropolitan Statistical Area,AAPI,767,723,44,Statistcially significant disparity,1.5299904,1.5,15,12757,649,13406
10580,"Albany-Schenectady-Troy, NY",880736,Metropolitan Statistical Area,Black,135,118,17,Regression equation needs to be tweaked,1.798811287,1.8,18,4533,197,4730
10580,"Albany-Schenectady-Troy, NY",880736,Metropolitan Statistical Area,Latino,141,130,11,Regression equation needs to be tweaked,1.225177131,1.2,12,4533,197,4730
10580,"Albany-Schenectady-Troy, NY",880736,Metropolitan Statistical Area,Native American,11,10,1,Regression equation needs to be tweaked,2.142022838,2.1,21,4533,197,4730
10580,"Albany-Schenectady-Troy, NY",880736,Metropolitan Statistical Area,AAPI,454,433,21,Regression equation needs to be tweaked,0.558278108,0.6,6,4533,197,4730
36140,"Ocean City, NJ",93086,Metropolitan Statistical Area,Black,3,3,0,No meaningful results,,,,546,42,588
36140,"Ocean City, NJ",93086,Metropolitan Statistical Area,Latino,10,10,0,No meaningful results,,,,546,42,588
36140,"Ocean City, NJ",93086,Metropolitan Statistical Area,Native American,2,2,0,No meaningful results,,,,546,42,588
36140,"Ocean City, NJ",93086,Metropolitan Statistical Area,AAPI,7,5,2,No meaningful results,,,,546,42,588
14860,"Bridgeport-Stamford-Norwalk, CT",943926,Metropolitan Statistical Area,Black,406,347,59,Statistcially significant disparity,1.568536353,1.6,16,4238,269,4507
14860,"Bridgeport-Stamford-Norwalk, CT",943926,Metropolitan Statistical Area,Latino,1038,931,107,Not statistcially significant,1.145244174,1.1,11,4238,269,4507
14860,"Bridgeport-Stamford-Norwalk, CT",943926,Metropolitan Statistical Area,Native American,11,10,1,Not statistcially significant,0.877471904,0.9,9,4238,269,4507
14860,"Bridgeport-Stamford-Norwalk, CT",943926,Metropolitan Statistical Area,AAPI,499,456,43,Not statistcially significant,1.395303514,1.4,14,4238,269,4507
15764,"Cambridge-Newton-Framingham, MA",2384518,Metropolitan Division,Black,374,339,35,Statistcially significant disparity,1.713427602,1.7,17,11791,471,12262
15764,"Cambridge-Newton-Framingham, MA",2384518,Metropolitan Division,Latino,1545,1418,127,Doesn't meet level of disparity,1.317313103,1.3,13,11791,471,12262
15764,"Cambridge-Newton-Framingham, MA",2384518,Metropolitan Division,Native American,20,18,2,Not statistcially significant,1.02617114,1,10,11791,471,12262
15764,"Cambridge-Newton-Framingham, MA",2384518,Metropolitan Division,AAPI,2742,2565,177,Statistcially significant disparity,1.74010495,1.7,17,11791,471,12262
45300,"Tampa-St. Petersburg-Clearwater, FL",3097859,Metropolitan Statistical Area,Black,1247,1064,183,Statistcially significant disparity,2.035562408,2,20,18613,1526,20139
45300,"Tampa-St. Petersburg-Clearwater, FL",3097859,Metropolitan Statistical Area,Latino,4069,3613,456,Doesn't meet level of disparity,1.425121445,1.4,14,18613,1526,20139
45300,"Tampa-St. Petersburg-Clearwater, FL",3097859,Metropolitan Statistical Area,Native American,76,68,8,Not statistcially significant,1.059043416,1.1,11,18613,1526,20139
45300,"Tampa-St. Petersburg-Clearwater, FL",3097859,Metropolitan Statistical Area,AAPI,1598,1417,181,Statistcially significant disparity,1.531490257,1.5,15,18613,1526,20139
29460,"Lakeland-Winter Haven, FL",686218,Metropolitan Statistical Area,Black,277,235,42,Regression equation needs to be tweaked,1.718352363,1.7,17,2437,208,2645
29460,"Lakeland-Winter Haven, FL",686218,Metropolitan Statistical Area,Latino,912,780,132,Regression equation needs to be tweaked,1.484356209,1.5,15,2437,208,2645
29460,"Lakeland-Winter Haven, FL",686218,Metropolitan Statistical Area,Native American,11,8,3,Regression equation needs to be tweaked,1.602343125,1.6,16,2437,208,2645
29460,"Lakeland-Winter Haven, FL",686218,Metropolitan Statistical Area,AAPI,145,131,14,Regression equation needs to be tweaked,0.980356438,1,10,2437,208,2645
45060,"Syracuse, NY",652416,Metropolitan Statistical Area,Black,96,85,11,Regression equation needs to be tweaked,1.421692958,1.4,14,2872,155,3027
45060,"Syracuse, NY",652416,Metropolitan Statistical Area,Latino,76,71,5,Regression equation needs to be tweaked,0.891332246,0.9,9,2872,155,3027
45060,"Syracuse, NY",652416,Metropolitan Statistical Area,Native American,16,14,2,Regression equation needs to be tweaked,2.14378129,2.1,21,2872,155,3027
45060,"Syracuse, NY",652416,Metropolitan Statistical Area,AAPI,195,180,15,Regression equation needs to be tweaked,1.283303647,1.3,13,2872,155,3027
37340,"Palm Bay-Melbourne-Titusville, FL",585507,Metropolitan Statistical Area,Black,170,140,30,Statistcially significant disparity,2.415474022,2.4,24,3606,306,3912
37340,"Palm Bay-Melbourne-Titusville, FL",585507,Metropolitan Statistical Area,Latino,419,368,51,Statistcially significant disparity,1.475262866,1.5,15,3606,306,3912
37340,"Palm Bay-Melbourne-Titusville, FL",585507,Metropolitan Statistical Area,Native American,17,14,3,Not statistcially significant,3.081044127,3.1,31,3606,306,3912
37340,"Palm Bay-Melbourne-Titusville, FL",585507,Metropolitan Statistical Area,AAPI,191,167,24,Not statistcially significant,1.576512837,1.6,16,3606,306,3912
28940,"Knoxville, TN",853337,Metropolitan Statistical Area,Black,163,143,20,Regression equation needs to be tweaked,1.721782768,1.7,17,6610,381,6991
28940,"Knoxville, TN",853337,Metropolitan Statistical Area,Latino,185,172,13,Regression equation needs to be tweaked,1.38746607,1.4,14,6610,381,6991
28940,"Knoxville, TN",853337,Metropolitan Statistical Area,Native American,17,17,0,Regression equation needs to be tweaked,5.75E-08,0,0,6610,381,6991
28940,"Knoxville, TN",853337,Metropolitan Statistical Area,AAPI,212,192,20,Regression equation needs to be tweaked,1.632675682,1.6,16,6610,381,6991
42940,"Sevierville, TN",97068,Micropolitan Statistical Area,Black,1,0,1,No meaningful results,,,,455,46,501
42940,"Sevierville, TN",97068,Micropolitan Statistical Area,Latino,12,5,7,No meaningful results,,,,455,46,501
42940,"Sevierville, TN",97068,Micropolitan Statistical Area,Native American,3,3,0,No meaningful results,,,,455,46,501
42940,"Sevierville, TN",97068,Micropolitan Statistical Area,AAPI,14,12,2,No meaningful results,,,,455,46,501
34100,"Morristown, TN",140912,Metropolitan Statistical Area,Black,4,4,0,No meaningful results,,,,572,49,621
34100,"Morristown, TN",140912,Metropolitan Statistical Area,Latino,29,25,4,No meaningful results,,,,572,49,621
34100,"Morristown, TN",140912,Metropolitan Statistical Area,Native American,3,2,1,No meaningful results,,,,572,49,621
34100,"Morristown, TN",140912,Metropolitan Statistical Area,AAPI,9,7,2,No meaningful results,,,,572,49,621
28700,"Kingsport-Bristol, TN-VA",306546,Metropolitan Statistical Area,Black,17,13,4,No meaningful results,,,,1609,116,1725
28700,"Kingsport-Bristol, TN-VA",306546,Metropolitan Statistical Area,Latino,26,22,4,No meaningful results,,,,1609,116,1725
28700,"Kingsport-Bristol, TN-VA",306546,Metropolitan Statistical Area,Native American,12,10,2,No meaningful results,,,,1609,116,1725
28700,"Kingsport-Bristol, TN-VA",306546,Metropolitan Statistical Area,AAPI,18,16,2,No meaningful results,,,,1609,116,1725
35460,"Newport, TN",35552,Micropolitan Statistical Area,Black,0,0,0,No meaningful results,,,,77,8,85
35460,"Newport, TN",35552,Micropolitan Statistical Area,Latino,0,0,0,No meaningful results,,,,77,8,85
35460,"Newport, TN",35552,Micropolitan Statistical Area,Native American,0,0,0,No meaningful results,,,,77,8,85
35460,"Newport, TN",35552,Micropolitan Statistical Area,AAPI,0,0,0,No meaningful results,,,,77,8,85
27740,"Johnson City, TN",202049,Metropolitan Statistical Area,Black,16,14,2,No meaningful results,,,,1146,81,1227
27740,"Johnson City, TN",202049,Metropolitan Statistical Area,Latino,27,25,2,No meaningful results,,,,1146,81,1227
27740,"Johnson City, TN",202049,Metropolitan Statistical Area,Native American,9,6,3,No meaningful results,,,,1146,81,1227
27740,"Johnson City, TN",202049,Metropolitan Statistical Area,AAPI,23,19,4,No meaningful results,,,,1146,81,1227
34980,"Nashville-Davidson--Murfreesboro--Franklin, TN",1871903,Metropolitan Statistical Area,Black,998,883,115,Statistcially significant disparity,1.837484289,1.8,18,16637,850,17487
34980,"Nashville-Davidson--Murfreesboro--Franklin, TN",1871903,Metropolitan Statistical Area,Latino,1080,985,95,Not statistcially significant,1.000660332,1,10,16637,850,17487
34980,"Nashville-Davidson--Murfreesboro--Franklin, TN",1871903,Metropolitan Statistical Area,Native American,56,54,2,Not statistcially significant,0.522453782,0.5,5,16637,850,17487
34980,"Nashville-Davidson--Murfreesboro--Franklin, TN",1871903,Metropolitan Statistical Area,AAPI,1023,924,99,Statistcially significant disparity,2.17364943,2.2,22,16637,850,17487
16860,"Chattanooga, TN-GA",556209,Metropolitan Statistical Area,Black,116,106,10,Regression equation needs to be tweaked,0.846612771,0.8,8,3735,200,3935
16860,"Chattanooga, TN-GA",556209,Metropolitan Statistical Area,Latino,150,136,14,Regression equation needs to be tweaked,1.072567,1.1,11,3735,200,3935
16860,"Chattanooga, TN-GA",556209,Metropolitan Statistical Area,Native American,11,10,1,Regression equation needs to be tweaked,2.522835959,2.5,25,3735,200,3935
16860,"Chattanooga, TN-GA",556209,Metropolitan Statistical Area,AAPI,139,130,9,Regression equation needs to be tweaked,1.553564902,1.6,16,3735,200,3935
18900,"Crossville, TN",59216,Micropolitan Statistical Area,Black,1,1,0,No meaningful results,,,,283,21,304
18900,"Crossville, TN",59216,Micropolitan Statistical Area,Latino,4,4,0,No meaningful results,,,,283,21,304
18900,"Crossville, TN",59216,Micropolitan Statistical Area,Native American,0,0,0,No meaningful results,,,,283,21,304
18900,"Crossville, TN",59216,Micropolitan Statistical Area,AAPI,4,3,1,No meaningful results,,,,283,21,304
24620,"Greeneville, TN",68834,Micropolitan Statistical Area,Black,2,2,0,No meaningful results,,,,229,17,246
24620,"Greeneville, TN",68834,Micropolitan Statistical Area,Latino,3,3,0,No meaningful results,,,,229,17,246
24620,"Greeneville, TN",68834,Micropolitan Statistical Area,Native American,0,0,0,No meaningful results,,,,229,17,246
24620,"Greeneville, TN",68834,Micropolitan Statistical Area,AAPI,1,1,0,No meaningful results,,,,229,17,246
17420,"Cleveland, TN",122563,Metropolitan Statistical Area,Black,11,9,2,No meaningful results,,,,561,27,588
17420,"Cleveland, TN",122563,Metropolitan Statistical Area,Latino,30,27,3,No meaningful results,,,,561,27,588
17420,"Cleveland, TN",122563,Metropolitan Statistical Area,Native American,1,1,0,No meaningful results,,,,561,27,588
17420,"Cleveland, TN",122563,Metropolitan Statistical Area,AAPI,11,9,2,No meaningful results,,,,561,27,588
48864,"Wilmington, DE-MD-NJ",721707,Metropolitan Division,Black,553,494,59,Regression equation needs to be tweaked,2.193169463,2.2,22,3193,137,3330
48864,"Wilmington, DE-MD-NJ",721707,Metropolitan Division,Latino,264,242,22,Regression equation needs to be tweaked,1.438060153,1.4,14,3193,137,3330
48864,"Wilmington, DE-MD-NJ",721707,Metropolitan Division,Native American,17,16,1,Regression equation needs to be tweaked,0.43926497,0.4,4,3193,137,3330
48864,"Wilmington, DE-MD-NJ",721707,Metropolitan Division,AAPI,455,417,38,Regression equation needs to be tweaked,1.767881708,1.8,18,3193,137,3330
20100,"Dover, DE",176699,Metropolitan Statistical Area,Black,169,154,15,No meaningful results,,,,543,24,567
20100,"Dover, DE",176699,Metropolitan Statistical Area,Latino,22,19,3,No meaningful results,,,,543,24,567
20100,"Dover, DE",176699,Metropolitan Statistical Area,Native American,3,3,0,No meaningful results,,,,543,24,567
20100,"Dover, DE",176699,Metropolitan Statistical Area,AAPI,44,37,7,No meaningful results,,,,543,24,567
41540,"Salisbury, MD-DE",404417,Metropolitan Statistical Area,Black,113,97,16,Regression equation needs to be tweaked,2.435887476,2.4,24,2580,136,2716
41540,"Salisbury, MD-DE",404417,Metropolitan Statistical Area,Latino,96,86,10,Regression equation needs to be tweaked,1.484459727,1.5,15,2580,136,2716
41540,"Salisbury, MD-DE",404417,Metropolitan Statistical Area,Native American,7,6,1,Regression equation needs to be tweaked,2.53032941,2.5,25,2580,136,2716
41540,"Salisbury, MD-DE",404417,Metropolitan Statistical Area,AAPI,74,64,10,Regression equation needs to be tweaked,2.74047839,2.7,27,2580,136,2716
33980,"Morehead City, NC",69070,Micropolitan Statistical Area,Black,3,3,0,No meaningful results,,,,492,37,529
33980,"Morehead City, NC",69070,Micropolitan Statistical Area,Latino,9,9,0,No meaningful results,,,,492,37,529
33980,"Morehead City, NC",69070,Micropolitan Statistical Area,Native American,1,1,0,No meaningful results,,,,492,37,529
33980,"Morehead City, NC",69070,Micropolitan Statistical Area,AAPI,5,4,1,No meaningful results,,,,492,37,529
20500,"Durham-Chapel Hill, NC",626695,Metropolitan Statistical Area,Black,617,553,64,Statistcially significant disparity,2.086632112,2.1,21,4680,194,4874
20500,"Durham-Chapel Hill, NC",626695,Metropolitan Statistical Area,Latino,489,450,39,Statistcially significant disparity,1.700092248,1.7,17,4680,194,4874
20500,"Durham-Chapel Hill, NC",626695,Metropolitan Statistical Area,Native American,19,17,2,Not statistcially significant,1.992133003,2,20,4680,194,4874
20500,"Durham-Chapel Hill, NC",626695,Metropolitan Statistical Area,AAPI,493,460,33,Statistcially significant disparity,2.160685829,2.2,22,4680,194,4874
49180,"Winston-Salem, NC",666216,Metropolitan Statistical Area,Black,346,317,29,No meaningful results,,,,4101,234,4335
49180,"Winston-Salem, NC",666216,Metropolitan Statistical Area,Latino,415,368,47,No meaningful results,,,,4101,234,4335
49180,"Winston-Salem, NC",666216,Metropolitan Statistical Area,Native American,18,18,0,No meaningful results,,,,4101,234,4335
49180,"Winston-Salem, NC",666216,Metropolitan Statistical Area,AAPI,144,136,8,No meaningful results,,,,4101,234,4335
19660,"Deltona-Daytona Beach-Ormond Beach, FL",646288,Metropolitan Statistical Area,Black,179,156,23,Not statistcially significant,1.523654175,1.5,15,3953,377,4330
19660,"Deltona-Daytona Beach-Ormond Beach, FL",646288,Metropolitan Statistical Area,Latino,575,517,58,Not statistcially significant,1.127413548,1.1,11,3953,377,4330
19660,"Deltona-Daytona Beach-Ormond Beach, FL",646288,Metropolitan Statistical Area,Native American,18,13,5,Not enough of applications,4.06066157,4.1,41,3953,377,4330
19660,"Deltona-Daytona Beach-Ormond Beach, FL",646288,Metropolitan Statistical Area,AAPI,124,103,21,Statistcially significant disparity,2.097185146,2.1,21,3953,377,4330
16740,"Charlotte-Concord-Gastonia, NC-SC",2545560,Metropolitan Statistical Area,Black,2504,2220,284,Statistcially significant disparity,1.545077442,1.5,15,20276,1044,21320
16740,"Charlotte-Concord-Gastonia, NC-SC",2545560,Metropolitan Statistical Area,Latino,2465,2244,221,Doesn't meet level of disparity,1.318613848,1.3,13,20276,1044,21320
16740,"Charlotte-Concord-Gastonia, NC-SC",2545560,Metropolitan Statistical Area,Native American,86,75,11,Not statistcially significant,1.961944104,2,20,20276,1044,21320
16740,"Charlotte-Concord-Gastonia, NC-SC",2545560,Metropolitan Statistical Area,AAPI,2075,1918,157,Statistcially significant disparity,1.744791556,1.7,17,20276,1044,21320
27260,"Jacksonville, FL",1503574,Metropolitan Statistical Area,Black,821,710,111,Not statistcially significant,1.300628731,1.3,13,9683,726,10409
27260,"Jacksonville, FL",1503574,Metropolitan Statistical Area,Latino,1028,925,103,Not statistcially significant,1.141366075,1.1,11,9683,726,10409
27260,"Jacksonville, FL",1503574,Metropolitan Statistical Area,Native American,36,30,6,Not statistcially significant,1.614758538,1.6,16,9683,726,10409
27260,"Jacksonville, FL",1503574,Metropolitan Statistical Area,AAPI,792,698,94,Statistcially significant disparity,1.614616994,1.6,16,9683,726,10409
14380,"Boone, NC",54925,Micropolitan Statistical Area,Black,3,1,2,No meaningful results,,,,288,17,305
14380,"Boone, NC",54925,Micropolitan Statistical Area,Latino,8,7,1,No meaningful results,,,,288,17,305
14380,"Boone, NC",54925,Micropolitan Statistical Area,Native American,0,0,0,No meaningful results,,,,288,17,305
14380,"Boone, NC",54925,Micropolitan Statistical Area,AAPI,6,6,0,No meaningful results,,,,288,17,305
24660,"Greensboro-High Point, NC",762063,Metropolitan Statistical Area,Black,615,557,58,Statistcially significant disparity,1.780866796,1.8,18,3645,165,3810
24660,"Greensboro-High Point, NC",762063,Metropolitan Statistical Area,Latino,427,378,49,Statistcially significant disparity,2.734383768,2.7,27,3645,165,3810
24660,"Greensboro-High Point, NC",762063,Metropolitan Statistical Area,Native American,12,9,3,Not statistcially significant,4.203144101,4.2,42,3645,165,3810
24660,"Greensboro-High Point, NC",762063,Metropolitan Statistical Area,AAPI,362,334,28,Statistcially significant disparity,1.715722318,1.7,17,3645,165,3810
39580,"Raleigh-Cary, NC",1332311,Metropolitan Statistical Area,Black,1427,1290,137,Regression equation needs to be tweaked,2.186486697,2.2,22,12302,448,12750
39580,"Raleigh-Cary, NC",1332311,Metropolitan Statistical Area,Latino,1115,1019,96,Regression equation needs to be tweaked,1.764780647,1.8,18,12302,448,12750
39580,"Raleigh-Cary, NC",1332311,Metropolitan Statistical Area,Native American,51,50,1,Regression equation needs to be tweaked,1.318756544,1.3,13,12302,448,12750
39580,"Raleigh-Cary, NC",1332311,Metropolitan Statistical Area,AAPI,1942,1790,152,Regression equation needs to be tweaked,2.238226951,2.2,22,12302,448,12750
43140,"Shelby, NC",97282,Micropolitan Statistical Area,Black,22,20,2,No meaningful results,,,,332,26,358
43140,"Shelby, NC",97282,Micropolitan Statistical Area,Latino,18,16,2,No meaningful results,,,,332,26,358
43140,"Shelby, NC",97282,Micropolitan Statistical Area,Native American,0,0,0,No meaningful results,,,,332,26,358
43140,"Shelby, NC",97282,Micropolitan Statistical Area,AAPI,5,4,1,No meaningful results,,,,332,26,358
34940,"Naples-Marco Island, FL",371453,Metropolitan Statistical Area,Black,71,51,20,Not enough of applications,3.234823161,3.2,32,2374,292,2666
34940,"Naples-Marco Island, FL",371453,Metropolitan Statistical Area,Latino,570,496,74,Not statistcially significant,1.064486842,1.1,11,2374,292,2666
34940,"Naples-Marco Island, FL",371453,Metropolitan Statistical Area,Native American,14,13,1,Not statistcially significant,0.531674355,0.5,5,2374,292,2666
34940,"Naples-Marco Island, FL",371453,Metropolitan Statistical Area,AAPI,78,59,19,Statistcially significant disparity,2.325236663,2.3,23,2374,292,2666
37860,"Pensacola-Ferry Pass-Brent, FL",488246,Metropolitan Statistical Area,Black,110,95,15,Not statistcially significant,0.851529127,0.9,9,2424,177,2601
37860,"Pensacola-Ferry Pass-Brent, FL",488246,Metropolitan Statistical Area,Latino,115,98,17,Statistcially significant disparity,2.213743475,2.2,22,2424,177,2601
37860,"Pensacola-Ferry Pass-Brent, FL",488246,Metropolitan Statistical Area,Native American,17,15,2,Not statistcially significant,2.24626323,2.2,22,2424,177,2601
37860,"Pensacola-Ferry Pass-Brent, FL",488246,Metropolitan Statistical Area,AAPI,102,93,9,Not statistcially significant,1.079424544,1.1,11,2424,177,2601
19124,"Dallas-Plano-Irving, TX",4903580,Metropolitan Division,Black,2619,2287,332,Statistcially significant disparity,2.146247774,2.1,21,23851,1210,25061
19124,"Dallas-Plano-Irving, TX",4903580,Metropolitan Division,Latino,6952,6372,580,Doesn't meet level of disparity,1.171376313,1.2,12,23851,1210,25061
19124,"Dallas-Plano-Irving, TX",4903580,Metropolitan Division,Native American,211,198,13,Not statistcially significant,1.362688479,1.4,14,23851,1210,25061
19124,"Dallas-Plano-Irving, TX",4903580,Metropolitan Division,AAPI,6699,6138,561,Statistcially significant disparity,1.747223497,1.7,17,23851,1210,25061
41700,"San Antonio-New Braunfels, TX",2468193,Metropolitan Statistical Area,Black,417,361,56,Statistcially significant disparity,2.124109247,2.1,21,7262,435,7697
41700,"San Antonio-New Braunfels, TX",2468193,Metropolitan Statistical Area,Latino,4849,4291,558,Statistcially significant disparity,1.573011616,1.6,16,7262,435,7697
41700,"San Antonio-New Braunfels, TX",2468193,Metropolitan Statistical Area,Native American,57,47,10,Not enough of applications,4.899703595,4.9,49,7262,435,7697
41700,"San Antonio-New Braunfels, TX",2468193,Metropolitan Statistical Area,AAPI,847,735,112,Statistcially significant disparity,2.594234811,2.6,26,7262,435,7697
15980,"Cape Coral-Fort Myers, FL",737468,Metropolitan Statistical Area,Black,227,191,36,Not statistcially significant,1.338292449,1.3,13,4892,485,5377
15980,"Cape Coral-Fort Myers, FL",737468,Metropolitan Statistical Area,Latino,1099,940,159,Statistcially significant disparity,1.497204896,1.5,15,4892,485,5377
15980,"Cape Coral-Fort Myers, FL",737468,Metropolitan Statistical Area,Native American,18,18,0,Not statistcially significant,8.26E-16,0,0,4892,485,5377
15980,"Cape Coral-Fort Myers, FL",737468,Metropolitan Statistical Area,AAPI,150,128,22,Not statistcially significant,1.751471278,1.8,18,4892,485,5377
26420,"Houston-The Woodlands-Sugar Land, TX",6884138,Metropolitan Statistical Area,Black,3887,3334,553,Statistcially significant disparity,2.058335596,2.1,21,25744,1565,27309
26420,"Houston-The Woodlands-Sugar Land, TX",6884138,Metropolitan Statistical Area,Latino,11573,10453,1120,Doesn't meet level of disparity,1.259638795,1.3,13,25744,1565,27309
26420,"Houston-The Woodlands-Sugar Land, TX",6884138,Metropolitan Statistical Area,Native American,200,183,17,Not statistcially significant,1.681105094,1.7,17,25744,1565,27309
26420,"Houston-The Woodlands-Sugar Land, TX",6884138,Metropolitan Statistical Area,AAPI,7013,6362,651,Doesn't meet level of disparity,1.438930292,1.4,14,25744,1565,27309
12420,"Austin-Round Rock-Georgetown, TX",2114441,Metropolitan Statistical Area,Black,622,561,61,Statistcially significant disparity,1.596923244,1.6,16,15875,884,16759
12420,"Austin-Round Rock-Georgetown, TX",2114441,Metropolitan Statistical Area,Latino,3451,3148,303,Doesn't meet level of disparity,1.32084238,1.3,13,15875,884,16759
12420,"Austin-Round Rock-Georgetown, TX",2114441,Metropolitan Statistical Area,Native American,106,96,10,Not statistcially significant,2.037433449,2,20,15875,884,16759
12420,"Austin-Round Rock-Georgetown, TX",2114441,Metropolitan Statistical Area,AAPI,3271,3013,258,Statistcially significant disparity,1.759199845,1.8,18,15875,884,16759
18880,"Crestview-Fort Walton Beach-Destin, FL",272056,Metropolitan Statistical Area,Black,33,30,3,Regression equation needs to be tweaked,0.753031396,0.8,8,1600,143,1743
18880,"Crestview-Fort Walton Beach-Destin, FL",272056,Metropolitan Statistical Area,Latino,105,92,13,Regression equation needs to be tweaked,1.452601336,1.5,15,1600,143,1743
18880,"Crestview-Fort Walton Beach-Destin, FL",272056,Metropolitan Statistical Area,Native American,9,9,0,Regression equation needs to be tweaked,3.85E-09,0,0,1600,143,1743
18880,"Crestview-Fort Walton Beach-Destin, FL",272056,Metropolitan Statistical Area,AAPI,63,60,3,Regression equation needs to be tweaked,0.700626961,0.7,7,1600,143,1743
47260,"Virginia Beach-Norfolk-Newport News, VA-NC",1761729,Metropolitan Statistical Area,Black,901,814,87,Regression equation needs to be tweaked,1.816458052,1.8,18,6578,276,6854
47260,"Virginia Beach-Norfolk-Newport News, VA-NC",1761729,Metropolitan Statistical Area,Latino,331,300,31,Regression equation needs to be tweaked,2.142944156,2.1,21,6578,276,6854
47260,"Virginia Beach-Norfolk-Newport News, VA-NC",1761729,Metropolitan Statistical Area,Native American,43,38,5,Regression equation needs to be tweaked,1.649771586,1.6,16,6578,276,6854
47260,"Virginia Beach-Norfolk-Newport News, VA-NC",1761729,Metropolitan Statistical Area,AAPI,560,531,29,Regression equation needs to be tweaked,0.903685073,0.9,9,6578,276,6854
40060,"Richmond, VA",1269530,Metropolitan Statistical Area,Black,853,782,71,Regression equation needs to be tweaked,2.855220945,2.9,29,7890,193,8083
40060,"Richmond, VA",1269530,Metropolitan Statistical Area,Latino,491,450,41,Regression equation needs to be tweaked,2.769311306,2.8,28,7890,193,8083
40060,"Richmond, VA",1269530,Metropolitan Statistical Area,Native American,38,35,3,Regression equation needs to be tweaked,2.690469958,2.7,27,7890,193,8083
40060,"Richmond, VA",1269530,Metropolitan Statistical Area,AAPI,809,757,52,Regression equation needs to be tweaked,2.701361046,2.7,27,7890,193,8083
23224,"Frederick-Gaithersburg-Rockville, MD",1294952,Metropolitan Division,Black,1195,1085,110,Statistcially significant disparity,2.03436734,2,20,5843,222,6065
23224,"Frederick-Gaithersburg-Rockville, MD",1294952,Metropolitan Division,Latino,1341,1234,107,Statistcially significant disparity,1.804313702,1.8,18,5843,222,6065
23224,"Frederick-Gaithersburg-Rockville, MD",1294952,Metropolitan Division,Native American,23,22,1,Not statistcially significant,1.728610064,1.7,17,5843,222,6065
23224,"Frederick-Gaithersburg-Rockville, MD",1294952,Metropolitan Division,AAPI,2091,1936,155,Statistcially significant disparity,1.803248651,1.8,18,5843,222,6065
31084,"Los Angeles-Long Beach-Glendale, CA",10081570,Metropolitan Division,Black,1352,1150,202,Statistcially significant disparity,1.741849324,1.7,17,16644,1575,18219
31084,"Los Angeles-Long Beach-Glendale, CA",10081570,Metropolitan Division,Latino,7587,6859,728,Doesn't meet level of disparity,1.138774223,1.1,11,16644,1575,18219
31084,"Los Angeles-Long Beach-Glendale, CA",10081570,Metropolitan Division,Native American,62,53,9,Not enough of applications,2.253591181,2.3,23,16644,1575,18219
31084,"Los Angeles-Long Beach-Glendale, CA",10081570,Metropolitan Division,AAPI,7900,7215,685,Not statistcially significant,1.04483204,1,10,16644,1575,18219
12260,"Augusta-Richmond County, GA-SC",599616,Metropolitan Statistical Area,Black,317,284,33,Regression equation needs to be tweaked,1.859552421,1.9,19,2309,93,2402
12260,"Augusta-Richmond County, GA-SC",599616,Metropolitan Statistical Area,Latino,128,116,12,Regression equation needs to be tweaked,1.983974683,2,20,2309,93,2402
12260,"Augusta-Richmond County, GA-SC",599616,Metropolitan Statistical Area,Native American,16,16,0,Regression equation needs to be tweaked,2.85E-08,0,0,2309,93,2402
12260,"Augusta-Richmond County, GA-SC",599616,Metropolitan Statistical Area,AAPI,142,133,9,Regression equation needs to be tweaked,2.112064388,2.1,21,2309,93,2402
25940,"Hilton Head Island-Bluffton, SC",214752,Metropolitan Statistical Area,Black,47,39,8,Regression equation needs to be tweaked,2.343744568,2.3,23,2025,109,2134
25940,"Hilton Head Island-Bluffton, SC",214752,Metropolitan Statistical Area,Latino,72,61,11,Regression equation needs to be tweaked,2.090240382,2.1,21,2025,109,2134
25940,"Hilton Head Island-Bluffton, SC",214752,Metropolitan Statistical Area,Native American,5,5,0,Regression equation needs to be tweaked,1.74E-07,0,0,2025,109,2134
25940,"Hilton Head Island-Bluffton, SC",214752,Metropolitan Statistical Area,AAPI,38,34,4,Regression equation needs to be tweaked,1.13986698,1.1,11,2025,109,2134
29404,"Lake County-Kenosha County, IL-WI",869997,Metropolitan Division,Black,171,152,19,Regression equation needs to be tweaked,1.696437414,1.7,17,5054,271,5325
29404,"Lake County-Kenosha County, IL-WI",869997,Metropolitan Division,Latino,974,863,111,Regression equation needs to be tweaked,1.513025102,1.5,15,5054,271,5325
29404,"Lake County-Kenosha County, IL-WI",869997,Metropolitan Division,Native American,11,8,3,Regression equation needs to be tweaked,2.900098782,2.9,29,5054,271,5325
29404,"Lake County-Kenosha County, IL-WI",869997,Metropolitan Division,AAPI,806,762,44,Regression equation needs to be tweaked,1.328209396,1.3,13,5054,271,5325
16984,"Chicago-Naperville-Evanston, IL",7175030,Metropolitan Division,Black,3035,2509,526,Statistcially significant disparity,2.445572713,2.4,24,33031,1677,34708
16984,"Chicago-Naperville-Evanston, IL",7175030,Metropolitan Division,Latino,7650,6807,843,Statistcially significant disparity,1.600461569,1.6,16,33031,1677,34708
16984,"Chicago-Naperville-Evanston, IL",7175030,Metropolitan Division,Native American,77,71,6,Not statistcially significant,1.473373307,1.5,15,33031,1677,34708
16984,"Chicago-Naperville-Evanston, IL",7175030,Metropolitan Division,AAPI,6063,5612,451,Doesn't meet level of disparity,1.394531528,1.4,14,33031,1677,34708
23844,"Gary, IN",701782,Metropolitan Division,Black,304,272,32,No meaningful results,,,,4358,146,4504
23844,"Gary, IN",701782,Metropolitan Division,Latino,622,578,44,No meaningful results,,,,4358,146,4504
23844,"Gary, IN",701782,Metropolitan Division,Native American,11,11,0,No meaningful results,,,,4358,146,4504
23844,"Gary, IN",701782,Metropolitan Division,AAPI,108,102,6,No meaningful results,,,,4358,146,4504
10300,"Adrian, MI",98381,Micropolitan Statistical Area,Black,0,0,0,No meaningful results,,,,532,31,563
10300,"Adrian, MI",98381,Micropolitan Statistical Area,Latino,21,20,1,No meaningful results,,,,532,31,563
10300,"Adrian, MI",98381,Micropolitan Statistical Area,Native American,3,3,0,No meaningful results,,,,532,31,563
10300,"Adrian, MI",98381,Micropolitan Statistical Area,AAPI,2,2,0,No meaningful results,,,,532,31,563
39540,"Racine, WI",195602,Metropolitan Statistical Area,Black,58,49,9,Regression equation needs to be tweaked,4.921793861,4.9,49,1455,72,1527
39540,"Racine, WI",195602,Metropolitan Statistical Area,Latino,161,142,19,Regression equation needs to be tweaked,2.483521689,2.5,25,1455,72,1527
39540,"Racine, WI",195602,Metropolitan Statistical Area,Native American,4,4,0,Regression equation needs to be tweaked,8.44E-19,0,0,1455,72,1527
39540,"Racine, WI",195602,Metropolitan Statistical Area,AAPI,29,24,5,Regression equation needs to be tweaked,5.217303768,5.2,52,1455,72,1527
20994,"Elgin, IL",761796,Metropolitan Division,Black,172,161,11,Not statistcially significant,1.293911951,1.3,13,4729,183,4912
20994,"Elgin, IL",761796,Metropolitan Division,Latino,1213,1100,113,Statistcially significant disparity,1.594396565,1.6,16,4729,183,4912
20994,"Elgin, IL",761796,Metropolitan Division,Native American,10,9,1,Not statistcially significant,0.996320152,1,10,4729,183,4912
20994,"Elgin, IL",761796,Metropolitan Division,AAPI,301,275,26,Statistcially significant disparity,2.199768484,2.2,22,4729,183,4912
16580,"Champaign-Urbana, IL",226323,Metropolitan Statistical Area,Black,58,50,8,No meaningful results,,,,1066,33,1099
16580,"Champaign-Urbana, IL",226323,Metropolitan Statistical Area,Latino,78,75,3,No meaningful results,,,,1066,33,1099
16580,"Champaign-Urbana, IL",226323,Metropolitan Statistical Area,Native American,7,7,0,No meaningful results,,,,1066,33,1099
16580,"Champaign-Urbana, IL",226323,Metropolitan Statistical Area,AAPI,105,99,6,No meaningful results,,,,1066,33,1099
11460,"Ann Arbor, MI",367000,Metropolitan Statistical Area,Black,124,113,11,Regression equation needs to be tweaked,1.403482007,1.4,14,2281,94,2375
11460,"Ann Arbor, MI",367000,Metropolitan Statistical Area,Latino,82,78,4,Regression equation needs to be tweaked,1.040212914,1,10,2281,94,2375
11460,"Ann Arbor, MI",367000,Metropolitan Statistical Area,Native American,7,7,0,Regression equation needs to be tweaked,3.61E-06,0,0,2281,94,2375
11460,"Ann Arbor, MI",367000,Metropolitan Statistical Area,AAPI,322,301,21,Regression equation needs to be tweaked,1.765590165,1.8,18,2281,94,2375
42644,"Seattle-Bellevue-Kent, WA",2994310,Metropolitan Division,Black,857,785,72,Statistcially significant disparity,1.739359778,1.7,17,17035,822,17857
42644,"Seattle-Bellevue-Kent, WA",2994310,Metropolitan Division,Latino,1609,1486,123,Statistcially significant disparity,1.546595272,1.5,15,17035,822,17857
42644,"Seattle-Bellevue-Kent, WA",2994310,Metropolitan Division,Native American,143,132,11,Not statistcially significant,1.691230539,1.7,17,17035,822,17857
42644,"Seattle-Bellevue-Kent, WA",2994310,Metropolitan Division,AAPI,8529,7968,561,Doesn't meet level of disparity,1.411199259,1.4,14,17035,822,17857
11244,"Anaheim-Santa Ana-Irvine, CA",3168044,Metropolitan Division,Black,140,126,14,Not statistcially significant,1.103870246,1.1,11,8752,730,9482
11244,"Anaheim-Santa Ana-Irvine, CA",3168044,Metropolitan Division,Latino,1996,1849,147,Not statistcially significant,1.123557611,1.1,11,8752,730,9482
11244,"Anaheim-Santa Ana-Irvine, CA",3168044,Metropolitan Division,Native American,31,29,2,Not statistcially significant,0.426433769,0.4,4,8752,730,9482
11244,"Anaheim-Santa Ana-Irvine, CA",3168044,Metropolitan Division,AAPI,4924,4499,425,Not statistcially significant,1.158811472,1.2,12,8752,730,9482
36084,"Oakland-Berkeley-Livermore, CA",2799005,Metropolitan Division,Black,655,591,64,Regression equation needs to be tweaked,1.657565826,1.7,17,7172,372,7544
36084,"Oakland-Berkeley-Livermore, CA",2799005,Metropolitan Division,Latino,1895,1759,136,Regression equation needs to be tweaked,1.224709493,1.2,12,7172,372,7544
36084,"Oakland-Berkeley-Livermore, CA",2799005,Metropolitan Division,Native American,54,48,6,Regression equation needs to be tweaked,1.755271126,1.8,18,7172,372,7544
36084,"Oakland-Berkeley-Livermore, CA",2799005,Metropolitan Division,AAPI,8870,8101,769,Regression equation needs to be tweaked,1.477489041,1.5,15,7172,372,7544
37100,"Oxnard-Thousand Oaks-Ventura, CA",847263,Metropolitan Statistical Area,Black,79,70,9,Not statistcially significant,1.792816717,1.8,18,2825,193,3018
37100,"Oxnard-Thousand Oaks-Ventura, CA",847263,Metropolitan Statistical Area,Latino,988,902,86,Statistcially significant disparity,1.453126584,1.5,15,2825,193,3018
37100,"Oxnard-Thousand Oaks-Ventura, CA",847263,Metropolitan Statistical Area,Native American,13,13,0,Not statistcially significant,4.53E-20,0,0,2825,193,3018
37100,"Oxnard-Thousand Oaks-Ventura, CA",847263,Metropolitan Statistical Area,AAPI,463,434,29,Not statistcially significant,0.957839192,1,10,2825,193,3018
40140,"Riverside-San Bernardino-Ontario, CA",4560470,Metropolitan Statistical Area,Black,1037,890,147,Statistcially significant disparity,1.638717269,1.6,16,10184,806,10990
40140,"Riverside-San Bernardino-Ontario, CA",4560470,Metropolitan Statistical Area,Latino,7778,7063,715,Not statistcially significant,1.098715577,1.1,11,10184,806,10990
40140,"Riverside-San Bernardino-Ontario, CA",4560470,Metropolitan Statistical Area,Native American,97,88,9,Not statistcially significant,1.43403914,1.4,14,10184,806,10990
40140,"Riverside-San Bernardino-Ontario, CA",4560470,Metropolitan Statistical Area,AAPI,3165,2843,322,Not statistcially significant,1.151788199,1.2,12,10184,806,10990
12540,"Bakersfield, CA",887641,Metropolitan Statistical Area,Black,79,74,5,Not statistcially significant,0.386684617,0.4,4,1823,97,1920
12540,"Bakersfield, CA",887641,Metropolitan Statistical Area,Latino,1471,1365,106,Not statistcially significant,0.848064175,0.8,8,1823,97,1920
12540,"Bakersfield, CA",887641,Metropolitan Statistical Area,Native American,20,18,2,Not statistcially significant,0.988032898,1,10,1823,97,1920
12540,"Bakersfield, CA",887641,Metropolitan Statistical Area,AAPI,384,362,22,Not statistcially significant,0.907928252,0.9,9,1823,97,1920
41940,"San Jose-Sunnyvale-Santa Clara, CA",1987846,Metropolitan Statistical Area,Black,103,88,15,Regression equation needs to be tweaked,2.124642482,2.1,21,3008,186,3194
41940,"San Jose-Sunnyvale-Santa Clara, CA",1987846,Metropolitan Statistical Area,Latino,907,831,76,Regression equation needs to be tweaked,1.310598194,1.3,13,3008,186,3194
41940,"San Jose-Sunnyvale-Santa Clara, CA",1987846,Metropolitan Statistical Area,Native American,20,20,0,Regression equation needs to be tweaked,3.12E-06,0,0,3008,186,3194
41940,"San Jose-Sunnyvale-Santa Clara, CA",1987846,Metropolitan Statistical Area,AAPI,7485,6898,587,Regression equation needs to be tweaked,1.335989718,1.3,13,3008,186,3194
41740,"San Diego-Chula Vista-Carlsbad, CA",3316073,Metropolitan Statistical Area,Black,287,255,32,Regression equation needs to be tweaked,1.486134,1.5,15,10418,799,11217
41740,"San Diego-Chula Vista-Carlsbad, CA",3316073,Metropolitan Statistical Area,Latino,2595,2341,254,Regression equation needs to be tweaked,1.450615057,1.5,15,10418,799,11217
41740,"San Diego-Chula Vista-Carlsbad, CA",3316073,Metropolitan Statistical Area,Native American,52,45,7,Regression equation needs to be tweaked,2.290478156,2.3,23,10418,799,11217
41740,"San Diego-Chula Vista-Carlsbad, CA",3316073,Metropolitan Statistical Area,AAPI,2852,2601,251,Regression equation needs to be tweaked,1.302502404,1.3,13,10418,799,11217
40900,"Sacramento-Roseville-Folsom, CA",2315980,Metropolitan Statistical Area,Black,590,539,51,Statistcially significant disparity,1.545358822,1.5,15,10262,545,10807
40900,"Sacramento-Roseville-Folsom, CA",2315980,Metropolitan Statistical Area,Latino,2089,1941,148,Not statistcially significant,1.189432896,1.2,12,10262,545,10807
40900,"Sacramento-Roseville-Folsom, CA",2315980,Metropolitan Statistical Area,Native American,83,75,8,Not statistcially significant,2.10502854,2.1,21,10262,545,10807
40900,"Sacramento-Roseville-Folsom, CA",2315980,Metropolitan Statistical Area,AAPI,3446,3140,306,Statistcially significant disparity,1.696300849,1.7,17,10262,545,10807
46700,"Vallejo, CA",441829,Metropolitan Statistical Area,Black,216,194,22,Statistcially significant disparity,1.937464548,1.9,19,1164,66,1230
46700,"Vallejo, CA",441829,Metropolitan Statistical Area,Latino,517,485,32,Not statistcially significant,0.950789825,1,10,1164,66,1230
46700,"Vallejo, CA",441829,Metropolitan Statistical Area,Native American,16,15,1,Not statistcially significant,1.450424236,1.5,15,1164,66,1230
46700,"Vallejo, CA",441829,Metropolitan Statistical Area,AAPI,519,476,43,Not statistcially significant,1.41068232,1.4,14,1164,66,1230
12060,"Atlanta-Sandy Springs-Alpharetta, GA",5862424,Metropolitan Statistical Area,Black,8334,7077,1257,Statistcially significant disparity,1.729935721,1.7,17,28736,1846,30582
12060,"Atlanta-Sandy Springs-Alpharetta, GA",5862424,Metropolitan Statistical Area,Latino,4410,4014,396,Not statistcially significant,1.050990169,1.1,11,28736,1846,30582
12060,"Atlanta-Sandy Springs-Alpharetta, GA",5862424,Metropolitan Statistical Area,Native American,135,117,18,Not statistcially significant,1.576133351,1.6,16,28736,1846,30582
12060,"Atlanta-Sandy Springs-Alpharetta, GA",5862424,Metropolitan Statistical Area,AAPI,6023,5543,480,Not statistcially significant,1.067021645,1.1,11,28736,1846,30582
45580,"Thomaston, GA",26236,Micropolitan Statistical Area,Black,3,2,1,No meaningful results,,,,74,4,78
45580,"Thomaston, GA",26236,Micropolitan Statistical Area,Latino,1,1,0,No meaningful results,,,,74,4,78
45580,"Thomaston, GA",26236,Micropolitan Statistical Area,Native American,1,1,0,No meaningful results,,,,74,4,78
45580,"Thomaston, GA",26236,Micropolitan Statistical Area,AAPI,0,0,0,No meaningful results,,,,74,4,78
31420,"Macon-Bibb County, GA",229504,Metropolitan Statistical Area,Black,95,82,13,No meaningful results,,,,662,32,694
31420,"Macon-Bibb County, GA",229504,Metropolitan Statistical Area,Latino,19,16,3,No meaningful results,,,,662,32,694
31420,"Macon-Bibb County, GA",229504,Metropolitan Statistical Area,Native American,0,0,0,No meaningful results,,,,662,32,694
31420,"Macon-Bibb County, GA",229504,Metropolitan Statistical Area,AAPI,25,21,4,No meaningful results,,,,662,32,694
40660,"Rome, GA",97369,Metropolitan Statistical Area,Black,19,18,1,No meaningful results,,,,367,18,385
40660,"Rome, GA",97369,Metropolitan Statistical Area,Latino,26,24,2,No meaningful results,,,,367,18,385
40660,"Rome, GA",97369,Metropolitan Statistical Area,Native American,1,0,1,No meaningful results,,,,367,18,385
40660,"Rome, GA",97369,Metropolitan Statistical Area,AAPI,16,13,3,No meaningful results,,,,367,18,385
29300,"LaGrange, GA-AL",103579,Micropolitan Statistical Area,Black,27,25,2,No meaningful results,,,,264,18,282
29300,"LaGrange, GA-AL",103579,Micropolitan Statistical Area,Latino,6,5,1,No meaningful results,,,,264,18,282
29300,"LaGrange, GA-AL",103579,Micropolitan Statistical Area,Native American,1,1,0,No meaningful results,,,,264,18,282
29300,"LaGrange, GA-AL",103579,Micropolitan Statistical Area,AAPI,18,18,0,No meaningful results,,,,264,18,282
36100,"Ocala, FL",353526,Metropolitan Statistical Area,Black,112,99,13,Regression equation needs to be tweaked,1.515830863,1.5,15,1986,176,2162
36100,"Ocala, FL",353526,Metropolitan Statistical Area,Latino,272,232,40,Regression equation needs to be tweaked,1.585357077,1.6,16,1986,176,2162
36100,"Ocala, FL",353526,Metropolitan Statistical Area,Native American,5,4,1,Regression equation needs to be tweaked,7.643627027,7.6,76,1986,176,2162
36100,"Ocala, FL",353526,Metropolitan Statistical Area,AAPI,71,60,11,Regression equation needs to be tweaked,2.444247216,2.4,24,1986,176,2162
42340,"Savannah, GA",386036,Metropolitan Statistical Area,Black,216,191,25,Regression equation needs to be tweaked,1.489178035,1.5,15,1833,118,1951
42340,"Savannah, GA",386036,Metropolitan Statistical Area,Latino,103,90,13,Regression equation needs to be tweaked,1.432936521,1.4,14,1833,118,1951
42340,"Savannah, GA",386036,Metropolitan Statistical Area,Native American,9,9,0,Regression equation needs to be tweaked,6.83E-05,0,0,1833,118,1951
42340,"Savannah, GA",386036,Metropolitan Statistical Area,AAPI,114,104,10,Regression equation needs to be tweaked,1.174750634,1.2,12,1833,118,1951
27600,"Jefferson, GA",67885,Micropolitan Statistical Area,Black,29,25,4,No meaningful results,,,,678,34,712
27600,"Jefferson, GA",67885,Micropolitan Statistical Area,Latino,51,47,4,No meaningful results,,,,678,34,712
27600,"Jefferson, GA",67885,Micropolitan Statistical Area,Native American,5,5,0,No meaningful results,,,,678,34,712
27600,"Jefferson, GA",67885,Micropolitan Statistical Area,AAPI,39,34,5,No meaningful results,,,,678,34,712
12020,"Athens-Clarke County, GA",208457,Metropolitan Statistical Area,Black,41,38,3,Regression equation needs to be tweaked,0.731334271,0.7,7,1015,46,1061
12020,"Athens-Clarke County, GA",208457,Metropolitan Statistical Area,Latino,73,67,6,Regression equation needs to be tweaked,0.711447464,0.7,7,1015,46,1061
12020,"Athens-Clarke County, GA",208457,Metropolitan Statistical Area,Native American,5,5,0,Regression equation needs to be tweaked,2.44E-07,0,0,1015,46,1061
12020,"Athens-Clarke County, GA",208457,Metropolitan Statistical Area,AAPI,53,45,8,Regression equation needs to be tweaked,7.396000052,7.4,74,1015,46,1061
15260,"Brunswick, GA",117400,Metropolitan Statistical Area,Black,26,25,1,Regression equation needs to be tweaked,0.170618677,0.2,2,535,38,573
15260,"Brunswick, GA",117400,Metropolitan Statistical Area,Latino,26,23,3,Regression equation needs to be tweaked,0.273404762,0.3,3,535,38,573
15260,"Brunswick, GA",117400,Metropolitan Statistical Area,Native American,4,4,0,Regression equation needs to be tweaked,1.80E-09,0,0,535,38,573
15260,"Brunswick, GA",117400,Metropolitan Statistical Area,AAPI,7,6,1,Regression equation needs to be tweaked,0.805384916,0.8,8,535,38,573
23580,"Gainesville, GA",198667,Metropolitan Statistical Area,Black,48,41,7,Regression equation needs to be tweaked,1.713993364,1.7,17,1277,76,1353
23580,"Gainesville, GA",198667,Metropolitan Statistical Area,Latino,236,220,16,Regression equation needs to be tweaked,0.863750088,0.9,9,1277,76,1353
23580,"Gainesville, GA",198667,Metropolitan Statistical Area,Native American,1,1,0,Regression equation needs to be tweaked,1.68E-06,0,0,1277,76,1353
23580,"Gainesville, GA",198667,Metropolitan Statistical Area,AAPI,66,53,13,Regression equation needs to be tweaked,3.93793895,3.9,39,1277,76,1353
18460,"Cornelia, GA",44626,Micropolitan Statistical Area,Black,2,2,0,No meaningful results,,,,187,10,197
18460,"Cornelia, GA",44626,Micropolitan Statistical Area,Latino,18,18,0,No meaningful results,,,,187,10,197
18460,"Cornelia, GA",44626,Micropolitan Statistical Area,Native American,1,1,0,No meaningful results,,,,187,10,197
18460,"Cornelia, GA",44626,Micropolitan Statistical Area,AAPI,5,5,0,No meaningful results,,,,187,10,197
33460,"Minneapolis-St. Paul-Bloomington, MN-WI",3573609,Metropolitan Statistical Area,Black,1486,1341,145,Statistcially significant disparity,2.174761984,2.2,22,31226,1045,32271
33460,"Minneapolis-St. Paul-Bloomington, MN-WI",3573609,Metropolitan Statistical Area,Latino,1318,1226,92,Statistcially significant disparity,1.492818675,1.5,15,31226,1045,32271
33460,"Minneapolis-St. Paul-Bloomington, MN-WI",3573609,Metropolitan Statistical Area,Native American,160,150,10,Statistcially significant disparity,2.043537395,2,20,31226,1045,32271
33460,"Minneapolis-St. Paul-Bloomington, MN-WI",3573609,Metropolitan Statistical Area,AAPI,2971,2801,170,Statistcially significant disparity,1.787711112,1.8,18,31226,1045,32271
47580,"Warner Robins, GA",180652,Metropolitan Statistical Area,Black,157,146,11,No meaningful results,,,,673,38,711
47580,"Warner Robins, GA",180652,Metropolitan Statistical Area,Latino,38,38,0,No meaningful results,,,,673,38,711
47580,"Warner Robins, GA",180652,Metropolitan Statistical Area,Native American,2,2,0,No meaningful results,,,,673,38,711
47580,"Warner Robins, GA",180652,Metropolitan Statistical Area,AAPI,63,58,5,No meaningful results,,,,673,38,711
45740,"Toccoa, GA",25750,Micropolitan Statistical Area,Black,2,2,0,No meaningful results,,,,73,8,81
45740,"Toccoa, GA",25750,Micropolitan Statistical Area,Latino,2,2,0,No meaningful results,,,,73,8,81
45740,"Toccoa, GA",25750,Micropolitan Statistical Area,Native American,1,1,0,No meaningful results,,,,73,8,81
45740,"Toccoa, GA",25750,Micropolitan Statistical Area,AAPI,1,1,0,No meaningful results,,,,73,8,81
45540,"The Villages, FL",125044,Metropolitan Statistical Area,Black,19,16,3,No meaningful results,,,,1809,70,1879
45540,"The Villages, FL",125044,Metropolitan Statistical Area,Latino,48,45,3,No meaningful results,,,,1809,70,1879
45540,"The Villages, FL",125044,Metropolitan Statistical Area,Native American,5,5,0,No meaningful results,,,,1809,70,1879
45540,"The Villages, FL",125044,Metropolitan Statistical Area,AAPI,12,10,2,No meaningful results,,,,1809,70,1879
17140,"Cincinnati, OH-KY-IN",2201741,Metropolitan Statistical Area,Black,826,731,95,Statistcially significant disparity,2.284398658,2.3,23,16122,586,16708
17140,"Cincinnati, OH-KY-IN",2201741,Metropolitan Statistical Area,Latino,478,433,45,Statistcially significant disparity,2.020878262,2,20,16122,586,16708
17140,"Cincinnati, OH-KY-IN",2201741,Metropolitan Statistical Area,Native American,36,35,1,Not statistcially significant,0.568014145,0.6,6,16122,586,16708
17140,"Cincinnati, OH-KY-IN",2201741,Metropolitan Statistical Area,AAPI,1021,954,67,Statistcially significant disparity,1.928284863,1.9,19,16122,586,16708
15660,"Calhoun, GA",57202,Micropolitan Statistical Area,Black,4,4,0,No meaningful results,,,,185,22,207
15660,"Calhoun, GA",57202,Micropolitan Statistical Area,Latino,37,33,4,No meaningful results,,,,185,22,207
15660,"Calhoun, GA",57202,Micropolitan Statistical Area,Native American,1,1,0,No meaningful results,,,,185,22,207
15660,"Calhoun, GA",57202,Micropolitan Statistical Area,AAPI,12,11,1,No meaningful results,,,,185,22,207
38240,"Pinehurst-Southern Pines, NC",97294,Micropolitan Statistical Area,Black,21,21,0,No meaningful results,,,,649,43,692
38240,"Pinehurst-Southern Pines, NC",97294,Micropolitan Statistical Area,Latino,30,25,5,No meaningful results,,,,649,43,692
38240,"Pinehurst-Southern Pines, NC",97294,Micropolitan Statistical Area,Native American,6,4,2,No meaningful results,,,,649,43,692
38240,"Pinehurst-Southern Pines, NC",97294,Micropolitan Statistical Area,AAPI,10,10,0,No meaningful results,,,,649,43,692
44340,"Statesboro, GA",76120,Micropolitan Statistical Area,Black,18,18,0,No meaningful results,,,,244,13,257
44340,"Statesboro, GA",76120,Micropolitan Statistical Area,Latino,9,7,2,No meaningful results,,,,244,13,257
44340,"Statesboro, GA",76120,Micropolitan Statistical Area,Native American,0,0,0,No meaningful results,,,,244,13,257
44340,"Statesboro, GA",76120,Micropolitan Statistical Area,AAPI,8,7,1,No meaningful results,,,,244,13,257
21020,"Elizabeth City, NC",52944,Micropolitan Statistical Area,Black,21,19,2,No meaningful results,,,,162,10,172
21020,"Elizabeth City, NC",52944,Micropolitan Statistical Area,Latino,7,7,0,No meaningful results,,,,162,10,172
21020,"Elizabeth City, NC",52944,Micropolitan Statistical Area,Native American,2,2,0,No meaningful results,,,,162,10,172
21020,"Elizabeth City, NC",52944,Micropolitan Statistical Area,AAPI,5,5,0,No meaningful results,,,,162,10,172
39340,"Provo-Orem, UT",616791,Metropolitan Statistical Area,Black,38,33,5,Regression equation needs to be tweaked,1.985816098,2,20,6340,254,6594
39340,"Provo-Orem, UT",616791,Metropolitan Statistical Area,Latino,604,572,32,Regression equation needs to be tweaked,1.032254301,1,10,6340,254,6594
39340,"Provo-Orem, UT",616791,Metropolitan Statistical Area,Native American,20,19,1,Regression equation needs to be tweaked,1.265705857,1.3,13,6340,254,6594
39340,"Provo-Orem, UT",616791,Metropolitan Statistical Area,AAPI,306,292,14,Regression equation needs to be tweaked,1.370671185,1.4,14,6340,254,6594
19740,"Denver-Aurora-Lakewood, CO",2892066,Metropolitan Statistical Area,Black,718,658,60,Statistcially significant disparity,1.636294081,1.6,16,25663,1154,26817
19740,"Denver-Aurora-Lakewood, CO",2892066,Metropolitan Statistical Area,Latino,3408,3154,254,Statistcially significant disparity,1.573839162,1.6,16,25663,1154,26817
19740,"Denver-Aurora-Lakewood, CO",2892066,Metropolitan Statistical Area,Native American,138,130,8,Not statistcially significant,1.2325414,1.2,12,25663,1154,26817
19740,"Denver-Aurora-Lakewood, CO",2892066,Metropolitan Statistical Area,AAPI,2325,2145,180,Statistcially significant disparity,1.541076099,1.5,15,25663,1154,26817
25980,"Hinesville, GA",80041,Metropolitan Statistical Area,Black,16,13,3,No meaningful results,,,,67,3,70
25980,"Hinesville, GA",80041,Metropolitan Statistical Area,Latino,15,8,7,No meaningful results,,,,67,3,70
25980,"Hinesville, GA",80041,Metropolitan Statistical Area,Native American,1,1,0,No meaningful results,,,,67,3,70
25980,"Hinesville, GA",80041,Metropolitan Statistical Area,AAPI,6,6,0,No meaningful results,,,,67,3,70
10420,"Akron, OH",703845,Metropolitan Statistical Area,Black,230,203,27,Statistcially significant disparity,2.456509771,2.5,25,4500,170,4670
10420,"Akron, OH",703845,Metropolitan Statistical Area,Latino,92,86,6,Not statistcially significant,1.391236276,1.4,14,4500,170,4670
10420,"Akron, OH",703845,Metropolitan Statistical Area,Native American,13,13,0,Not statistcially significant,1.37E-14,0,0,4500,170,4670
10420,"Akron, OH",703845,Metropolitan Statistical Area,AAPI,333,305,28,Statistcially significant disparity,1.807514693,1.8,18,4500,170,4670
41620,"Salt Lake City, UT",1201043,Metropolitan Statistical Area,Black,101,92,9,Not statistcially significant,1.384366336,1.4,14,9707,474,10181
41620,"Salt Lake City, UT",1201043,Metropolitan Statistical Area,Latino,1369,1259,110,Not statistcially significant,1.274494439,1.3,13,9707,474,10181
41620,"Salt Lake City, UT",1201043,Metropolitan Statistical Area,Native American,42,39,3,Not statistcially significant,1.915132622,1.9,19,9707,474,10181
41620,"Salt Lake City, UT",1201043,Metropolitan Statistical Area,AAPI,890,834,56,Not statistcially significant,1.226294751,1.2,12,9707,474,10181
24860,"Greenville-Anderson, SC",895942,Metropolitan Statistical Area,Black,339,278,61,No meaningful results,,,,6767,341,7108
24860,"Greenville-Anderson, SC",895942,Metropolitan Statistical Area,Latino,414,373,41,No meaningful results,,,,6767,341,7108
24860,"Greenville-Anderson, SC",895942,Metropolitan Statistical Area,Native American,17,17,0,No meaningful results,,,,6767,341,7108
24860,"Greenville-Anderson, SC",895942,Metropolitan Statistical Area,AAPI,276,244,32,No meaningful results,,,,6767,341,7108
26140,"Homosassa Springs, FL",145169,Metropolitan Statistical Area,Black,15,14,1,No meaningful results,,,,1022,102,1124
26140,"Homosassa Springs, FL",145169,Metropolitan Statistical Area,Latino,56,47,9,No meaningful results,,,,1022,102,1124
26140,"Homosassa Springs, FL",145169,Metropolitan Statistical Area,Native American,5,4,1,No meaningful results,,,,1022,102,1124
26140,"Homosassa Springs, FL",145169,Metropolitan Statistical Area,AAPI,23,18,5,No meaningful results,,,,1022,102,1124
38060,"Phoenix-Mesa-Chandler, AZ",4761603,Metropolitan Statistical Area,Black,1384,1225,159,Statistcially significant disparity,1.895318243,1.9,19,34501,2002,36503
38060,"Phoenix-Mesa-Chandler, AZ",4761603,Metropolitan Statistical Area,Latino,8438,7753,685,Doesn't meet level of disparity,1.309540648,1.3,13,34501,2002,36503
38060,"Phoenix-Mesa-Chandler, AZ",4761603,Metropolitan Statistical Area,Native American,256,239,17,Not statistcially significant,0.93558746,0.9,9,34501,2002,36503
38060,"Phoenix-Mesa-Chandler, AZ",4761603,Metropolitan Statistical Area,AAPI,3187,2942,245,Doesn't meet level of disparity,1.325385981,1.3,13,34501,2002,36503
23104,"Fort Worth-Arlington-Grapevine, TX",2417083,Metropolitan Division,Black,1050,929,121,Statistcially significant disparity,2.043958888,2,20,11549,546,12095
23104,"Fort Worth-Arlington-Grapevine, TX",2417083,Metropolitan Division,Latino,3370,3124,246,Not statistcially significant,1.183858562,1.2,12,11549,546,12095
23104,"Fort Worth-Arlington-Grapevine, TX",2417083,Metropolitan Division,Native American,95,89,6,Not statistcially significant,1.629395564,1.6,16,11549,546,12095
23104,"Fort Worth-Arlington-Grapevine, TX",2417083,Metropolitan Division,AAPI,1759,1594,165,Statistcially significant disparity,1.840805846,1.8,18,11549,546,12095
21700,"Eureka-Arcata, CA",135940,Micropolitan Statistical Area,Black,4,2,2,No meaningful results,,,,462,22,484
21700,"Eureka-Arcata, CA",135940,Micropolitan Statistical Area,Latino,38,36,2,No meaningful results,,,,462,22,484
21700,"Eureka-Arcata, CA",135940,Micropolitan Statistical Area,Native American,11,11,0,No meaningful results,,,,462,22,484
21700,"Eureka-Arcata, CA",135940,Micropolitan Statistical Area,AAPI,21,20,1,No meaningful results,,,,462,22,484
33660,"Mobile, AL",430655,Metropolitan Statistical Area,Black,233,207,26,Regression equation needs to be tweaked,2.801624158,2.8,28,1455,56,1511
33660,"Mobile, AL",430655,Metropolitan Statistical Area,Latino,41,39,2,Regression equation needs to be tweaked,1.525683663,1.5,15,1455,56,1511
33660,"Mobile, AL",430655,Metropolitan Statistical Area,Native American,5,3,2,Regression equation needs to be tweaked,26.85989369,26.9,269,1455,56,1511
33660,"Mobile, AL",430655,Metropolitan Statistical Area,AAPI,65,61,4,Regression equation needs to be tweaked,1.215740759,1.2,12,1455,56,1511
36260,"Ogden-Clearfield, UT",662875,Metropolitan Statistical Area,Black,43,40,3,No meaningful results,,,,5843,268,6111
36260,"Ogden-Clearfield, UT",662875,Metropolitan Statistical Area,Latino,563,513,50,No meaningful results,,,,5843,268,6111
36260,"Ogden-Clearfield, UT",662875,Metropolitan Statistical Area,Native American,21,21,0,No meaningful results,,,,5843,268,6111
36260,"Ogden-Clearfield, UT",662875,Metropolitan Statistical Area,AAPI,154,146,8,No meaningful results,,,,5843,268,6111
33860,"Montgomery, AL",373544,Metropolitan Statistical Area,Black,411,316,95,Regression equation needs to be tweaked,2.005646269,2,20,1295,95,1390
33860,"Montgomery, AL",373544,Metropolitan Statistical Area,Latino,41,37,4,Regression equation needs to be tweaked,0.981144637,1,10,1295,95,1390
33860,"Montgomery, AL",373544,Metropolitan Statistical Area,Native American,4,4,0,Regression equation needs to be tweaked,5.92E-08,0,0,1295,95,1390
33860,"Montgomery, AL",373544,Metropolitan Statistical Area,AAPI,125,119,6,Regression equation needs to be tweaked,1.323527117,1.3,13,1295,95,1390
38940,"Port St. Lucie, FL",472012,Metropolitan Statistical Area,Black,300,247,53,Statistcially significant disparity,2.40326266,2.4,24,2845,277,3122
38940,"Port St. Lucie, FL",472012,Metropolitan Statistical Area,Latino,560,494,66,Not statistcially significant,1.165568334,1.2,12,2845,277,3122
38940,"Port St. Lucie, FL",472012,Metropolitan Statistical Area,Native American,16,15,1,Not statistcially significant,0.934357934,0.9,9,2845,277,3122
38940,"Port St. Lucie, FL",472012,Metropolitan Statistical Area,AAPI,81,63,18,Statistcially significant disparity,3.114429686,3.1,31,2845,277,3122
34820,"Myrtle Beach-Conway-North Myrtle Beach, SC-NC",463987,Metropolitan Statistical Area,Black,136,122,14,Regression equation needs to be tweaked,1.216210168,1.2,12,4679,353,5032
34820,"Myrtle Beach-Conway-North Myrtle Beach, SC-NC",463987,Metropolitan Statistical Area,Latino,129,108,21,Regression equation needs to be tweaked,1.618261576,1.6,16,4679,353,5032
34820,"Myrtle Beach-Conway-North Myrtle Beach, SC-NC",463987,Metropolitan Statistical Area,Native American,24,18,6,Regression equation needs to be tweaked,2.799174104,2.8,28,4679,353,5032
34820,"Myrtle Beach-Conway-North Myrtle Beach, SC-NC",463987,Metropolitan Statistical Area,AAPI,79,69,10,Regression equation needs to be tweaked,1.323203215,1.3,13,4679,353,5032
26620,"Huntsville, AL",457003,Metropolitan Statistical Area,Black,417,379,38,No meaningful results,,,,3834,128,3962
26620,"Huntsville, AL",457003,Metropolitan Statistical Area,Latino,153,141,12,No meaningful results,,,,3834,128,3962
26620,"Huntsville, AL",457003,Metropolitan Statistical Area,Native American,21,21,0,No meaningful results,,,,3834,128,3962
26620,"Huntsville, AL",457003,Metropolitan Statistical Area,AAPI,194,184,10,No meaningful results,,,,3834,128,3962
42680,"Sebastian-Vero Beach, FL",153989,Metropolitan Statistical Area,Black,21,17,4,Regression equation needs to be tweaked,3.734390556,3.7,37,1208,112,1320
42680,"Sebastian-Vero Beach, FL",153989,Metropolitan Statistical Area,Latino,120,111,9,Regression equation needs to be tweaked,0.522982171,0.5,5,1208,112,1320
42680,"Sebastian-Vero Beach, FL",153989,Metropolitan Statistical Area,Native American,2,2,0,Regression equation needs to be tweaked,3.36E-11,0,0,1208,112,1320
42680,"Sebastian-Vero Beach, FL",153989,Metropolitan Statistical Area,AAPI,20,17,3,Regression equation needs to be tweaked,0.95319641,1,10,1208,112,1320
23420,"Fresno, CA",984521,Metropolitan Statistical Area,Black,110,101,9,Not statistcially significant,1.8964836,1.9,19,2153,111,2264
23420,"Fresno, CA",984521,Metropolitan Statistical Area,Latino,1641,1520,121,Not statistcially significant,1.349210242,1.3,13,2153,111,2264
23420,"Fresno, CA",984521,Metropolitan Statistical Area,Native American,27,25,2,Not statistcially significant,1.5378278,1.5,15,2153,111,2264
23420,"Fresno, CA",984521,Metropolitan Statistical Area,AAPI,890,812,78,Statistcially significant disparity,1.451934778,1.5,15,2153,111,2264
20780,"Edwards, CO",54681,Micropolitan Statistical Area,Black,1,1,0,No meaningful results,,,,466,33,499
20780,"Edwards, CO",54681,Micropolitan Statistical Area,Latino,46,36,10,No meaningful results,,,,466,33,499
20780,"Edwards, CO",54681,Micropolitan Statistical Area,Native American,2,2,0,No meaningful results,,,,466,33,499
20780,"Edwards, CO",54681,Micropolitan Statistical Area,AAPI,6,6,0,No meaningful results,,,,466,33,499
13820,"Birmingham-Hoover, AL",1085330,Metropolitan Statistical Area,Black,973,865,108,Statistcially significant disparity,1.818210212,1.8,18,6690,220,6910
13820,"Birmingham-Hoover, AL",1085330,Metropolitan Statistical Area,Latino,294,258,36,Statistcially significant disparity,2.380833264,2.4,24,6690,220,6910
13820,"Birmingham-Hoover, AL",1085330,Metropolitan Statistical Area,Native American,18,15,3,Not statistcially significant,2.163753613,2.2,22,6690,220,6910
13820,"Birmingham-Hoover, AL",1085330,Metropolitan Statistical Area,AAPI,254,233,21,Statistcially significant disparity,1.775722107,1.8,18,6690,220,6910
21340,"El Paso, TX",840477,Metropolitan Statistical Area,Black,47,44,3,Not statistcially significant,1.303560438,1.3,13,422,36,458
21340,"El Paso, TX",840477,Metropolitan Statistical Area,Latino,2195,2022,173,Not statistcially significant,0.894105458,0.9,9,422,36,458
21340,"El Paso, TX",840477,Metropolitan Statistical Area,Native American,5,3,2,Not enough of applications,11.43602166,11.4,114,422,36,458
21340,"El Paso, TX",840477,Metropolitan Statistical Area,AAPI,62,55,7,Not statistcially significant,1.691347777,1.7,17,422,36,458
17900,"Columbia, SC",824278,Metropolitan Statistical Area,Black,670,582,88,Regression equation needs to be tweaked,2.297750129,2.3,23,3939,198,4137
17900,"Columbia, SC",824278,Metropolitan Statistical Area,Latino,193,175,18,Regression equation needs to be tweaked,1.572221499,1.6,16,3939,198,4137
17900,"Columbia, SC",824278,Metropolitan Statistical Area,Native American,15,12,3,Regression equation needs to be tweaked,2.924890478,2.9,29,3939,198,4137
17900,"Columbia, SC",824278,Metropolitan Statistical Area,AAPI,210,196,14,Regression equation needs to be tweaked,1.332511667,1.3,13,3939,198,4137
17980,"Columbus, GA-AL",319402,Metropolitan Statistical Area,Black,115,97,18,No meaningful results,,,,656,33,689
17980,"Columbus, GA-AL",319402,Metropolitan Statistical Area,Latino,39,36,3,No meaningful results,,,,656,33,689
17980,"Columbus, GA-AL",319402,Metropolitan Statistical Area,Native American,10,7,3,No meaningful results,,,,656,33,689
17980,"Columbus, GA-AL",319402,Metropolitan Statistical Area,AAPI,47,46,1,No meaningful results,,,,656,33,689
20660,"Easton, MD",37167,Micropolitan Statistical Area,Black,5,5,0,No meaningful results,,,,210,7,217
20660,"Easton, MD",37167,Micropolitan Statistical Area,Latino,9,8,1,No meaningful results,,,,210,7,217
20660,"Easton, MD",37167,Micropolitan Statistical Area,Native American,0,0,0,No meaningful results,,,,210,7,217
20660,"Easton, MD",37167,Micropolitan Statistical Area,AAPI,5,5,0,No meaningful results,,,,210,7,217
10500,"Albany, GA",148436,Metropolitan Statistical Area,Black,53,42,11,No meaningful results,,,,224,12,236
10500,"Albany, GA",148436,Metropolitan Statistical Area,Latino,7,7,0,No meaningful results,,,,224,12,236
10500,"Albany, GA",148436,Metropolitan Statistical Area,Native American,0,0,0,No meaningful results,,,,224,12,236
10500,"Albany, GA",148436,Metropolitan Statistical Area,AAPI,14,13,1,No meaningful results,,,,224,12,236
14260,"Boise City, ID",710743,Metropolitan Statistical Area,Black,57,54,3,Regression equation needs to be tweaked,2.277674332,2.3,23,8244,285,8529
14260,"Boise City, ID",710743,Metropolitan Statistical Area,Latino,690,654,36,Regression equation needs to be tweaked,1.327823377,1.3,13,8244,285,8529
14260,"Boise City, ID",710743,Metropolitan Statistical Area,Native American,55,53,2,Regression equation needs to be tweaked,1.135257286,1.1,11,8244,285,8529
14260,"Boise City, ID",710743,Metropolitan Statistical Area,AAPI,325,304,21,Regression equation needs to be tweaked,1.956114689,2,20,8244,285,8529
45104,"Tacoma-Lakewood, WA",877013,Metropolitan Division,Black,287,255,32,Regression equation needs to be tweaked,2.381513868,2.4,24,4910,236,5146
45104,"Tacoma-Lakewood, WA",877013,Metropolitan Division,Latino,431,399,32,Regression equation needs to be tweaked,1.324786121,1.3,13,4910,236,5146
45104,"Tacoma-Lakewood, WA",877013,Metropolitan Division,Native American,55,52,3,Regression equation needs to be tweaked,1.669786492,1.7,17,4910,236,5146
45104,"Tacoma-Lakewood, WA",877013,Metropolitan Division,AAPI,687,629,58,Regression equation needs to be tweaked,1.485999201,1.5,15,4910,236,5146
11700,"Asheville, NC",454351,Metropolitan Statistical Area,Black,50,42,8,No meaningful results,,,,3620,224,3844
11700,"Asheville, NC",454351,Metropolitan Statistical Area,Latino,151,128,23,No meaningful results,,,,3620,224,3844
11700,"Asheville, NC",454351,Metropolitan Statistical Area,Native American,15,14,1,No meaningful results,,,,3620,224,3844
11700,"Asheville, NC",454351,Metropolitan Statistical Area,AAPI,72,62,10,No meaningful results,,,,3620,224,3844
43620,"Sioux Falls, SD",259348,Metropolitan Statistical Area,Black,35,34,1,No meaningful results,,,,2240,66,2306
43620,"Sioux Falls, SD",259348,Metropolitan Statistical Area,Latino,51,49,2,No meaningful results,,,,2240,66,2306
43620,"Sioux Falls, SD",259348,Metropolitan Statistical Area,Native American,16,15,1,No meaningful results,,,,2240,66,2306
43620,"Sioux Falls, SD",259348,Metropolitan Statistical Area,AAPI,33,33,0,No meaningful results,,,,2240,66,2306
28060,"Kalispell, MT",99899,Micropolitan Statistical Area,Black,1,1,0,No meaningful results,,,,784,55,839
28060,"Kalispell, MT",99899,Micropolitan Statistical Area,Latino,11,11,0,No meaningful results,,,,784,55,839
28060,"Kalispell, MT",99899,Micropolitan Statistical Area,Native American,9,7,2,No meaningful results,,,,784,55,839
28060,"Kalispell, MT",99899,Micropolitan Statistical Area,AAPI,7,7,0,No meaningful results,,,,784,55,839
41100,"St. George, UT",165811,Metropolitan Statistical Area,Black,11,11,0,No meaningful results,,,,1765,119,1884
41100,"St. George, UT",165811,Metropolitan Statistical Area,Latino,110,102,8,No meaningful results,,,,1765,119,1884
41100,"St. George, UT",165811,Metropolitan Statistical Area,Native American,7,7,0,No meaningful results,,,,1765,119,1884
41100,"St. George, UT",165811,Metropolitan Statistical Area,AAPI,35,30,5,No meaningful results,,,,1765,119,1884
24300,"Grand Junction, CO",151218,Metropolitan Statistical Area,Black,5,5,0,No meaningful results,,,,1384,72,1456
24300,"Grand Junction, CO",151218,Metropolitan Statistical Area,Latino,124,114,10,No meaningful results,,,,1384,72,1456
24300,"Grand Junction, CO",151218,Metropolitan Statistical Area,Native American,9,9,0,No meaningful results,,,,1384,72,1456
24300,"Grand Junction, CO",151218,Metropolitan Statistical Area,AAPI,29,28,1,No meaningful results,,,,1384,72,1456
44460,"Steamboat Springs, CO",25072,Micropolitan Statistical Area,Black,2,2,0,No meaningful results,,,,253,23,276
44460,"Steamboat Springs, CO",25072,Micropolitan Statistical Area,Latino,6,6,0,No meaningful results,,,,253,23,276
44460,"Steamboat Springs, CO",25072,Micropolitan Statistical Area,Native American,2,2,0,No meaningful results,,,,253,23,276
44460,"Steamboat Springs, CO",25072,Micropolitan Statistical Area,AAPI,2,1,1,No meaningful results,,,,253,23,276
24060,"Glenwood Springs, CO",76981,Micropolitan Statistical Area,Black,5,4,1,Regression equation needs to be tweaked,1.748927635,1.7,17,535,39,574
24060,"Glenwood Springs, CO",76981,Micropolitan Statistical Area,Latino,87,77,10,Regression equation needs to be tweaked,2.470349256,2.5,25,535,39,574
24060,"Glenwood Springs, CO",76981,Micropolitan Statistical Area,Native American,5,5,0,Regression equation needs to be tweaked,6.03E-09,0,0,535,39,574
24060,"Glenwood Springs, CO",76981,Micropolitan Statistical Area,AAPI,8,7,1,Regression equation needs to be tweaked,3.815728331,3.8,38,535,39,574
40940,"Safford, AZ",37996,Micropolitan Statistical Area,Black,1,1,0,No meaningful results,,,,105,1,106
40940,"Safford, AZ",37996,Micropolitan Statistical Area,Latino,25,23,2,No meaningful results,,,,105,1,106
40940,"Safford, AZ",37996,Micropolitan Statistical Area,Native American,0,0,0,No meaningful results,,,,105,1,106
40940,"Safford, AZ",37996,Micropolitan Statistical Area,AAPI,1,1,0,No meaningful results,,,,105,1,106
42220,"Santa Rosa-Petaluma, CA",499772,Metropolitan Statistical Area,Black,25,24,1,No meaningful results,,,,1903,113,2016
42220,"Santa Rosa-Petaluma, CA",499772,Metropolitan Statistical Area,Latino,309,285,24,No meaningful results,,,,1903,113,2016
42220,"Santa Rosa-Petaluma, CA",499772,Metropolitan Statistical Area,Native American,16,16,0,No meaningful results,,,,1903,113,2016
42220,"Santa Rosa-Petaluma, CA",499772,Metropolitan Statistical Area,AAPI,200,182,18,No meaningful results,,,,1903,113,2016
34580,"Mount Vernon-Anacortes, WA",125612,Metropolitan Statistical Area,Black,4,3,1,No meaningful results,,,,857,46,903
34580,"Mount Vernon-Anacortes, WA",125612,Metropolitan Statistical Area,Latino,75,66,9,No meaningful results,,,,857,46,903
34580,"Mount Vernon-Anacortes, WA",125612,Metropolitan Statistical Area,Native American,6,5,1,No meaningful results,,,,857,46,903
34580,"Mount Vernon-Anacortes, WA",125612,Metropolitan Statistical Area,AAPI,34,32,2,No meaningful results,,,,857,46,903
39900,"Reno, NV",460924,Metropolitan Statistical Area,Black,34,31,3,Not statistcially significant,1.165947249,1.2,12,3066,147,3213
39900,"Reno, NV",460924,Metropolitan Statistical Area,Latino,496,457,39,Not statistcially significant,1.284119064,1.3,13,3066,147,3213
39900,"Reno, NV",460924,Metropolitan Statistical Area,Native American,19,18,1,Not statistcially significant,2.323733972,2.3,23,3066,147,3213
39900,"Reno, NV",460924,Metropolitan Statistical Area,AAPI,267,246,21,Not statistcially significant,1.471325071,1.5,15,3066,147,3213
36420,"Oklahoma City, OK",1382841,Metropolitan Statistical Area,Black,280,241,39,No meaningful results,,,,6717,301,7018
36420,"Oklahoma City, OK",1382841,Metropolitan Statistical Area,Latino,817,747,70,No meaningful results,,,,6717,301,7018
36420,"Oklahoma City, OK",1382841,Metropolitan Statistical Area,Native American,342,328,14,No meaningful results,,,,6717,301,7018
36420,"Oklahoma City, OK",1382841,Metropolitan Statistical Area,AAPI,525,486,39,No meaningful results,,,,6717,301,7018
28180,"Kapaa, HI",71769,Micropolitan Statistical Area,Black,4,4,0,No meaningful results,,,,169,14,183
28180,"Kapaa, HI",71769,Micropolitan Statistical Area,Latino,18,18,0,No meaningful results,,,,169,14,183
28180,"Kapaa, HI",71769,Micropolitan Statistical Area,Native American,2,2,0,No meaningful results,,,,169,14,183
28180,"Kapaa, HI",71769,Micropolitan Statistical Area,AAPI,104,92,12,No meaningful results,,,,169,14,183
44700,"Stockton, CA",742603,Metropolitan Statistical Area,Black,222,192,30,No meaningful results,,,,1501,85,1586
44700,"Stockton, CA",742603,Metropolitan Statistical Area,Latino,1289,1163,126,No meaningful results,,,,1501,85,1586
44700,"Stockton, CA",742603,Metropolitan Statistical Area,Native American,21,20,1,No meaningful results,,,,1501,85,1586
44700,"Stockton, CA",742603,Metropolitan Statistical Area,AAPI,1637,1457,180,No meaningful results,,,,1501,85,1586
23940,"Gillette, WY",61930,Micropolitan Statistical Area,Black,0,0,0,No meaningful results,,,,172,8,180
23940,"Gillette, WY",61930,Micropolitan Statistical Area,Latino,9,8,1,No meaningful results,,,,172,8,180
23940,"Gillette, WY",61930,Micropolitan Statistical Area,Native American,1,1,0,No meaningful results,,,,172,8,180
23940,"Gillette, WY",61930,Micropolitan Statistical Area,AAPI,1,1,0,No meaningful results,,,,172,8,180
14720,"Breckenridge, CO",30649,Micropolitan Statistical Area,Black,2,1,1,No meaningful results,,,,377,30,407
14720,"Breckenridge, CO",30649,Micropolitan Statistical Area,Latino,17,14,3,No meaningful results,,,,377,30,407
14720,"Breckenridge, CO",30649,Micropolitan Statistical Area,Native American,2,1,1,No meaningful results,,,,377,30,407
14720,"Breckenridge, CO",30649,Micropolitan Statistical Area,AAPI,8,8,0,No meaningful results,,,,377,30,407
33940,"Montrose, CO",46482,Micropolitan Statistical Area,Black,0,0,0,No meaningful results,,,,339,11,350
33940,"Montrose, CO",46482,Micropolitan Statistical Area,Latino,37,33,4,No meaningful results,,,,339,11,350
33940,"Montrose, CO",46482,Micropolitan Statistical Area,Native American,2,1,1,No meaningful results,,,,339,11,350
33940,"Montrose, CO",46482,Micropolitan Statistical Area,AAPI,2,2,0,No meaningful results,,,,339,11,350
29820,"Las Vegas-Henderson-Paradise, NV",2182004,Metropolitan Statistical Area,Black,1070,938,132,Doesn't meet level of disparity,1.429259918,1.4,14,9453,859,10312
29820,"Las Vegas-Henderson-Paradise, NV",2182004,Metropolitan Statistical Area,Latino,3624,3263,361,Not statistcially significant,0.936677357,0.9,9,9453,859,10312
29820,"Las Vegas-Henderson-Paradise, NV",2182004,Metropolitan Statistical Area,Native American,77,67,10,Not statistcially significant,1.56215903,1.6,16,9453,859,10312
29820,"Las Vegas-Henderson-Paradise, NV",2182004,Metropolitan Statistical Area,AAPI,2734,2428,306,Doesn't meet level of disparity,1.223227222,1.2,12,9453,859,10312
40340,"Rochester, MN",217964,Metropolitan Statistical Area,Black,67,55,12,No meaningful results,,,,1958,93,2051
40340,"Rochester, MN",217964,Metropolitan Statistical Area,Latino,85,79,6,No meaningful results,,,,1958,93,2051
40340,"Rochester, MN",217964,Metropolitan Statistical Area,Native American,6,4,2,No meaningful results,,,,1958,93,2051
40340,"Rochester, MN",217964,Metropolitan Statistical Area,AAPI,149,142,7,No meaningful results,,,,1958,93,2051
15860,"Cañon City, CO",47321,Micropolitan Statistical Area,Black,2,2,0,No meaningful results,,,,217,21,238
15860,"Cañon City, CO",47321,Micropolitan Statistical Area,Latino,11,10,1,No meaningful results,,,,217,21,238
15860,"Cañon City, CO",47321,Micropolitan Statistical Area,Native American,0,0,0,No meaningful results,,,,217,21,238
15860,"Cañon City, CO",47321,Micropolitan Statistical Area,AAPI,1,1,0,No meaningful results,,,,217,21,238
28140,"Kansas City, MO-KS",2124518,Metropolitan Statistical Area,Black,698,624,74,Statistcially significant disparity,2.300593914,2.3,23,15863,544,16407
28140,"Kansas City, MO-KS",2124518,Metropolitan Statistical Area,Latino,1026,954,72,Doesn't meet level of disparity,1.444930116,1.4,14,15863,544,16407
28140,"Kansas City, MO-KS",2124518,Metropolitan Statistical Area,Native American,102,95,7,Not statistcially significant,2.10262175,2.1,21,15863,544,16407
28140,"Kansas City, MO-KS",2124518,Metropolitan Statistical Area,AAPI,771,714,57,Statistcially significant disparity,1.918306158,1.9,19,15863,544,16407
10740,"Albuquerque, NM",912108,Metropolitan Statistical Area,Black,96,86,10,Regression equation needs to be tweaked,2.581610992,2.6,26,3481,158,3639
10740,"Albuquerque, NM",912108,Metropolitan Statistical Area,Latino,1897,1748,149,Regression equation needs to be tweaked,1.534846564,1.5,15,3481,158,3639
10740,"Albuquerque, NM",912108,Metropolitan Statistical Area,Native American,89,85,4,Regression equation needs to be tweaked,0.851968386,0.9,9,3481,158,3639
10740,"Albuquerque, NM",912108,Metropolitan Statistical Area,AAPI,330,310,20,Regression equation needs to be tweaked,1.383567768,1.4,14,3481,158,3639
16700,"Charleston-North Charleston, SC",774508,Metropolitan Statistical Area,Black,531,444,87,Statistcially significant disparity,2.221092527,2.2,22,6864,457,7321
16700,"Charleston-North Charleston, SC",774508,Metropolitan Statistical Area,Latino,300,272,28,Not statistcially significant,1.065396218,1.1,11,6864,457,7321
16700,"Charleston-North Charleston, SC",774508,Metropolitan Statistical Area,Native American,31,29,2,Not statistcially significant,0.866733107,0.9,9,6864,457,7321
16700,"Charleston-North Charleston, SC",774508,Metropolitan Statistical Area,AAPI,222,198,24,Not statistcially significant,1.413581719,1.4,14,6864,457,7321
48300,"Wenatchee, WA",118252,Metropolitan Statistical Area,Black,1,1,0,No meaningful results,,,,723,46,769
48300,"Wenatchee, WA",118252,Metropolitan Statistical Area,Latino,111,101,10,No meaningful results,,,,723,46,769
48300,"Wenatchee, WA",118252,Metropolitan Statistical Area,Native American,10,9,1,No meaningful results,,,,723,46,769
48300,"Wenatchee, WA",118252,Metropolitan Statistical Area,AAPI,19,17,2,No meaningful results,,,,723,46,769
18780,"Craig, CO",13127,Micropolitan Statistical Area,Black,0,0,0,No meaningful results,,,,66,4,70
18780,"Craig, CO",13127,Micropolitan Statistical Area,Latino,4,4,0,No meaningful results,,,,66,4,70
18780,"Craig, CO",13127,Micropolitan Statistical Area,Native American,0,0,0,No meaningful results,,,,66,4,70
18780,"Craig, CO",13127,Micropolitan Statistical Area,AAPI,0,0,0,No meaningful results,,,,66,4,70
17820,"Colorado Springs, CO",723498,Metropolitan Statistical Area,Black,102,98,4,Regression equation needs to be tweaked,1.146839177,1.1,11,5055,210,5265
17820,"Colorado Springs, CO",723498,Metropolitan Statistical Area,Latino,542,511,31,Regression equation needs to be tweaked,1.183441521,1.2,12,5055,210,5265
17820,"Colorado Springs, CO",723498,Metropolitan Statistical Area,Native American,35,35,0,Regression equation needs to be tweaked,5.11E-08,0,0,5055,210,5265
17820,"Colorado Springs, CO",723498,Metropolitan Statistical Area,AAPI,244,226,18,Regression equation needs to be tweaked,1.869121672,1.9,19,5055,210,5265
46060,"Tucson, AZ",1027207,Metropolitan Statistical Area,Black,141,136,5,Regression equation needs to be tweaked,0.544848129,0.5,5,5559,289,5848
46060,"Tucson, AZ",1027207,Metropolitan Statistical Area,Latino,1582,1474,108,Regression equation needs to be tweaked,1.176161193,1.2,12,5559,289,5848
46060,"Tucson, AZ",1027207,Metropolitan Statistical Area,Native American,41,36,5,Regression equation needs to be tweaked,3.274599947,3.3,33,5559,289,5848
46060,"Tucson, AZ",1027207,Metropolitan Statistical Area,AAPI,372,345,27,Regression equation needs to be tweaked,1.382524946,1.4,14,5559,289,5848
14500,"Boulder, CO",322510,Metropolitan Statistical Area,Black,22,19,3,Regression equation needs to be tweaked,3.759607362,3.8,38,2842,123,2965
14500,"Boulder, CO",322510,Metropolitan Statistical Area,Latino,164,161,3,Regression equation needs to be tweaked,0.259215228,0.3,3,2842,123,2965
14500,"Boulder, CO",322510,Metropolitan Statistical Area,Native American,4,4,0,Regression equation needs to be tweaked,1.62E-07,0,0,2842,123,2965
14500,"Boulder, CO",322510,Metropolitan Statistical Area,AAPI,216,201,15,Regression equation needs to be tweaked,1.777020974,1.8,18,2842,123,2965
26660,"Huntsville, TX",72321,Micropolitan Statistical Area,Black,10,7,3,No meaningful results,,,,173,7,180
26660,"Huntsville, TX",72321,Micropolitan Statistical Area,Latino,21,17,4,No meaningful results,,,,173,7,180
26660,"Huntsville, TX",72321,Micropolitan Statistical Area,Native American,1,1,0,No meaningful results,,,,173,7,180
26660,"Huntsville, TX",72321,Micropolitan Statistical Area,AAPI,6,6,0,No meaningful results,,,,173,7,180
41500,"Salinas, CA",433410,Metropolitan Statistical Area,Black,12,11,1,Regression equation needs to be tweaked,1.623923339,1.6,16,723,58,781
41500,"Salinas, CA",433410,Metropolitan Statistical Area,Latino,543,490,53,Regression equation needs to be tweaked,1.038113089,1,10,723,58,781
41500,"Salinas, CA",433410,Metropolitan Statistical Area,Native American,6,4,2,Regression equation needs to be tweaked,7.243861075,7.2,72,723,58,781
41500,"Salinas, CA",433410,Metropolitan Statistical Area,AAPI,122,106,16,Regression equation needs to be tweaked,1.87269199,1.9,19,723,58,781
24540,"Greeley, CO",305345,Metropolitan Statistical Area,Black,20,17,3,Regression equation needs to be tweaked,2.053698587,2.1,21,3071,160,3231
24540,"Greeley, CO",305345,Metropolitan Statistical Area,Latino,564,523,41,Regression equation needs to be tweaked,1.352108733,1.4,14,3071,160,3231
24540,"Greeley, CO",305345,Metropolitan Statistical Area,Native American,21,19,2,Regression equation needs to be tweaked,1.698973109,1.7,17,3071,160,3231
24540,"Greeley, CO",305345,Metropolitan Statistical Area,AAPI,134,130,4,Regression equation needs to be tweaked,0.49097407,0.5,5,3071,160,3231
16100,"Carlsbad-Artesia, NM",57732,Micropolitan Statistical Area,Black,6,6,0,No meaningful results,,,,159,7,166
16100,"Carlsbad-Artesia, NM",57732,Micropolitan Statistical Area,Latino,70,62,8,No meaningful results,,,,159,7,166
16100,"Carlsbad-Artesia, NM",57732,Micropolitan Statistical Area,Native American,2,2,0,No meaningful results,,,,159,7,166
16100,"Carlsbad-Artesia, NM",57732,Micropolitan Statistical Area,AAPI,7,7,0,No meaningful results,,,,159,7,166
41884,"San Francisco-San Mateo-Redwood City, CA",1642384,Metropolitan Division,Black,74,64,10,Regression equation needs to be tweaked,2.050114523,2.1,21,3451,190,3641
41884,"San Francisco-San Mateo-Redwood City, CA",1642384,Metropolitan Division,Latino,365,336,29,Regression equation needs to be tweaked,1.494940449,1.5,15,3451,190,3641
41884,"San Francisco-San Mateo-Redwood City, CA",1642384,Metropolitan Division,Native American,14,12,2,Regression equation needs to be tweaked,2.566855722,2.6,26,3451,190,3641
41884,"San Francisco-San Mateo-Redwood City, CA",1642384,Metropolitan Division,AAPI,3354,3118,236,Regression equation needs to be tweaked,1.506800691,1.5,15,3451,190,3641
39150,"Prescott Valley-Prescott, AZ",228067,Metropolitan Statistical Area,Black,10,9,1,Not statistcially significant,0.403897122,0.4,4,1667,98,1765
39150,"Prescott Valley-Prescott, AZ",228067,Metropolitan Statistical Area,Latino,115,108,7,Not statistcially significant,0.87492132,0.9,9,1667,98,1765
39150,"Prescott Valley-Prescott, AZ",228067,Metropolitan Statistical Area,Native American,11,10,1,Not statistcially significant,4.606434824,4.6,46,1667,98,1765
39150,"Prescott Valley-Prescott, AZ",228067,Metropolitan Statistical Area,AAPI,19,17,2,Not enough of applications,5.471219131,5.5,55,1667,98,1765
42100,"Santa Cruz-Watsonville, CA",273962,Metropolitan Statistical Area,Black,6,6,0,No meaningful results,,,,931,54,985
42100,"Santa Cruz-Watsonville, CA",273962,Metropolitan Statistical Area,Latino,150,141,9,No meaningful results,,,,931,54,985
42100,"Santa Cruz-Watsonville, CA",273962,Metropolitan Statistical Area,Native American,3,2,1,No meaningful results,,,,931,54,985
42100,"Santa Cruz-Watsonville, CA",273962,Metropolitan Statistical Area,AAPI,76,64,12,No meaningful results,,,,931,54,985
22280,"Fernley, NV",54380,Micropolitan Statistical Area,Black,3,3,0,No meaningful results,,,,329,16,345
22280,"Fernley, NV",54380,Micropolitan Statistical Area,Latino,53,50,3,No meaningful results,,,,329,16,345
22280,"Fernley, NV",54380,Micropolitan Statistical Area,Native American,3,3,0,No meaningful results,,,,329,16,345
22280,"Fernley, NV",54380,Micropolitan Statistical Area,AAPI,6,6,0,No meaningful results,,,,329,16,345
36500,"Olympia-Lacey-Tumwater, WA",279711,Metropolitan Statistical Area,Black,36,35,1,No meaningful results,,,,1602,69,1671
36500,"Olympia-Lacey-Tumwater, WA",279711,Metropolitan Statistical Area,Latino,98,91,7,No meaningful results,,,,1602,69,1671
36500,"Olympia-Lacey-Tumwater, WA",279711,Metropolitan Statistical Area,Native American,17,16,1,No meaningful results,,,,1602,69,1671
36500,"Olympia-Lacey-Tumwater, WA",279711,Metropolitan Statistical Area,AAPI,182,166,16,No meaningful results,,,,1602,69,1671
33260,"Midland, TX",173816,Metropolitan Statistical Area,Black,58,51,7,Regression equation needs to be tweaked,1.56180686,1.6,16,1285,56,1341
33260,"Midland, TX",173816,Metropolitan Statistical Area,Latino,427,397,30,Regression equation needs to be tweaked,1.145292832,1.1,11,1285,56,1341
33260,"Midland, TX",173816,Metropolitan Statistical Area,Native American,13,13,0,Regression equation needs to be tweaked,5.21E-15,0,0,1285,56,1341
33260,"Midland, TX",173816,Metropolitan Statistical Area,AAPI,83,76,7,Regression equation needs to be tweaked,1.994222345,2,20,1285,56,1341
33140,"Michigan City-La Porte, IN",110154,Metropolitan Statistical Area,Black,21,19,2,Regression equation needs to be tweaked,1.68336413,1.7,17,627,40,667
33140,"Michigan City-La Porte, IN",110154,Metropolitan Statistical Area,Latino,48,39,9,Regression equation needs to be tweaked,3.27774941,3.3,33,627,40,667
33140,"Michigan City-La Porte, IN",110154,Metropolitan Statistical Area,Native American,2,1,1,Regression equation needs to be tweaked,45.81585181,45.8,458,627,40,667
33140,"Michigan City-La Porte, IN",110154,Metropolitan Statistical Area,AAPI,7,6,1,Regression equation needs to be tweaked,6.652380152,6.7,67,627,40,667
39380,"Pueblo, CO",165982,Metropolitan Statistical Area,Black,16,16,0,No meaningful results,,,,662,39,701
39380,"Pueblo, CO",165982,Metropolitan Statistical Area,Latino,229,212,17,No meaningful results,,,,662,39,701
39380,"Pueblo, CO",165982,Metropolitan Statistical Area,Native American,7,7,0,No meaningful results,,,,662,39,701
39380,"Pueblo, CO",165982,Metropolitan Statistical Area,AAPI,25,21,4,No meaningful results,,,,662,39,701
46520,"Urban Honolulu, HI",984821,Metropolitan Statistical Area,Black,28,24,4,Not statistcially significant,2.512412301,2.5,25,873,60,933
46520,"Urban Honolulu, HI",984821,Metropolitan Statistical Area,Latino,174,155,19,Not statistcially significant,1.749200724,1.7,17,873,60,933
46520,"Urban Honolulu, HI",984821,Metropolitan Statistical Area,Native American,14,11,3,Not enough of applications,4.528383956,4.5,45,873,60,933
46520,"Urban Honolulu, HI",984821,Metropolitan Statistical Area,AAPI,2779,2614,165,Not statistcially significant,0.949773421,0.9,9,873,60,933
39420,"Pullman, WA",49231,Micropolitan Statistical Area,Black,5,5,0,No meaningful results,,,,225,16,241
39420,"Pullman, WA",49231,Micropolitan Statistical Area,Latino,14,12,2,No meaningful results,,,,225,16,241
39420,"Pullman, WA",49231,Micropolitan Statistical Area,Native American,2,2,0,No meaningful results,,,,225,16,241
39420,"Pullman, WA",49231,Micropolitan Statistical Area,AAPI,14,14,0,No meaningful results,,,,225,16,241
17020,"Chico, CA",225817,Metropolitan Statistical Area,Black,10,9,1,Regression equation needs to be tweaked,5.077802954,5.1,51,1230,47,1277
17020,"Chico, CA",225817,Metropolitan Statistical Area,Latino,116,112,4,Regression equation needs to be tweaked,1.250535943,1.3,13,1230,47,1277
17020,"Chico, CA",225817,Metropolitan Statistical Area,Native American,11,10,1,Regression equation needs to be tweaked,2.957279976,3,30,1230,47,1277
17020,"Chico, CA",225817,Metropolitan Statistical Area,AAPI,44,41,3,Regression equation needs to be tweaked,2.221021535,2.2,22,1230,47,1277
33700,"Modesto, CA",543194,Metropolitan Statistical Area,Black,64,58,6,Not statistcially significant,1.939307166,1.9,19,1369,67,1436
33700,"Modesto, CA",543194,Metropolitan Statistical Area,Latino,1023,937,86,Not statistcially significant,1.397430513,1.4,14,1369,67,1436
33700,"Modesto, CA",543194,Metropolitan Statistical Area,Native American,10,7,3,Not enough of applications,7.540939461,7.5,75,1369,67,1436
33700,"Modesto, CA",543194,Metropolitan Statistical Area,AAPI,277,249,28,Not statistcially significant,1.588544987,1.6,16,1369,67,1436
42200,"Santa Maria-Santa Barbara, CA",444829,Metropolitan Statistical Area,Black,12,11,1,Regression equation needs to be tweaked,1.136932052,1.1,11,1152,83,1235
42200,"Santa Maria-Santa Barbara, CA",444829,Metropolitan Statistical Area,Latino,408,383,25,Regression equation needs to be tweaked,0.995225839,1,10,1152,83,1235
42200,"Santa Maria-Santa Barbara, CA",444829,Metropolitan Statistical Area,Native American,1,1,0,Regression equation needs to be tweaked,1.47E-10,0,0,1152,83,1235
42200,"Santa Maria-Santa Barbara, CA",444829,Metropolitan Statistical Area,AAPI,134,119,15,Regression equation needs to be tweaked,1.692218742,1.7,17,1152,83,1235
25260,"Hanford-Corcoran, CA",150691,Metropolitan Statistical Area,Black,6,5,1,Regression equation needs to be tweaked,35.95226172,36,360,209,7,216
25260,"Hanford-Corcoran, CA",150691,Metropolitan Statistical Area,Latino,174,164,10,Regression equation needs to be tweaked,2.650878679,2.7,27,209,7,216
25260,"Hanford-Corcoran, CA",150691,Metropolitan Statistical Area,Native American,1,1,0,Regression equation needs to be tweaked,0.000126002,0,0,209,7,216
25260,"Hanford-Corcoran, CA",150691,Metropolitan Statistical Area,AAPI,24,22,2,Regression equation needs to be tweaked,13.09794576,13.1,131,209,7,216
41060,"St. Cloud, MN",198581,Metropolitan Statistical Area,Black,37,28,9,No meaningful results,,,,1408,51,1459
41060,"St. Cloud, MN",198581,Metropolitan Statistical Area,Latino,35,32,3,No meaningful results,,,,1408,51,1459
41060,"St. Cloud, MN",198581,Metropolitan Statistical Area,Native American,5,3,2,No meaningful results,,,,1408,51,1459
41060,"St. Cloud, MN",198581,Metropolitan Statistical Area,AAPI,28,26,2,No meaningful results,,,,1408,51,1459
33540,"Missoula, MT",117309,Metropolitan Statistical Area,Black,5,5,0,No meaningful results,,,,997,38,1035
33540,"Missoula, MT",117309,Metropolitan Statistical Area,Latino,15,14,1,No meaningful results,,,,997,38,1035
33540,"Missoula, MT",117309,Metropolitan Statistical Area,Native American,7,7,0,No meaningful results,,,,997,38,1035
33540,"Missoula, MT",117309,Metropolitan Statistical Area,AAPI,12,12,0,No meaningful results,,,,997,38,1035
13380,"Bellingham, WA",220821,Metropolitan Statistical Area,Black,12,11,1,Regression equation needs to be tweaked,1.944303882,1.9,19,1496,87,1583
13380,"Bellingham, WA",220821,Metropolitan Statistical Area,Latino,60,50,10,Regression equation needs to be tweaked,2.985077994,3,30,1496,87,1583
13380,"Bellingham, WA",220821,Metropolitan Statistical Area,Native American,19,15,4,Regression equation needs to be tweaked,5.299475883,5.3,53,1496,87,1583
13380,"Bellingham, WA",220821,Metropolitan Statistical Area,AAPI,117,97,20,Regression equation needs to be tweaked,1.910892215,1.9,19,1496,87,1583
32900,"Merced, CA",271382,Metropolitan Statistical Area,Black,21,20,1,No meaningful results,,,,385,32,417
32900,"Merced, CA",271382,Metropolitan Statistical Area,Latino,639,568,71,No meaningful results,,,,385,32,417
32900,"Merced, CA",271382,Metropolitan Statistical Area,Native American,2,1,1,No meaningful results,,,,385,32,417
32900,"Merced, CA",271382,Metropolitan Statistical Area,AAPI,154,139,15,No meaningful results,,,,385,32,417
46860,"Vernal, UT",36084,Micropolitan Statistical Area,Black,0,0,0,No meaningful results,,,,127,5,132
46860,"Vernal, UT",36084,Micropolitan Statistical Area,Latino,13,11,2,No meaningful results,,,,127,5,132
46860,"Vernal, UT",36084,Micropolitan Statistical Area,Native American,1,1,0,No meaningful results,,,,127,5,132
46860,"Vernal, UT",36084,Micropolitan Statistical Area,AAPI,0,0,0,No meaningful results,,,,127,5,132
49100,"Winona, MN",50725,Micropolitan Statistical Area,Black,2,2,0,No meaningful results,,,,366,23,389
49100,"Winona, MN",50725,Micropolitan Statistical Area,Latino,4,2,2,No meaningful results,,,,366,23,389
49100,"Winona, MN",50725,Micropolitan Statistical Area,Native American,0,0,0,No meaningful results,,,,366,23,389
49100,"Winona, MN",50725,Micropolitan Statistical Area,AAPI,4,4,0,No meaningful results,,,,366,23,389
28100,"Kankakee, IL",110637,Metropolitan Statistical Area,Black,16,15,1,Regression equation needs to be tweaked,0.43046496,0.4,4,404,27,431
28100,"Kankakee, IL",110637,Metropolitan Statistical Area,Latino,25,20,5,Regression equation needs to be tweaked,2.563636401,2.6,26,404,27,431
28100,"Kankakee, IL",110637,Metropolitan Statistical Area,Native American,2,2,0,Regression equation needs to be tweaked,1.13E-09,0,0,404,27,431
28100,"Kankakee, IL",110637,Metropolitan Statistical Area,AAPI,7,6,1,Regression equation needs to be tweaked,0.114534502,0.1,1,404,27,431
39460,"Punta Gorda, FL",181067,Metropolitan Statistical Area,Black,41,37,4,Regression equation needs to be tweaked,1.034481129,1,10,1530,140,1670
39460,"Punta Gorda, FL",181067,Metropolitan Statistical Area,Latino,96,81,15,Regression equation needs to be tweaked,1.635122647,1.6,16,1530,140,1670
39460,"Punta Gorda, FL",181067,Metropolitan Statistical Area,Native American,5,4,1,Regression equation needs to be tweaked,5.965567508,6,60,1530,140,1670
39460,"Punta Gorda, FL",181067,Metropolitan Statistical Area,AAPI,27,24,3,Regression equation needs to be tweaked,1.159652384,1.2,12,1530,140,1670
39860,"Red Wing, MN",46246,Micropolitan Statistical Area,Black,0,0,0,No meaningful results,,,,335,16,351
39860,"Red Wing, MN",46246,Micropolitan Statistical Area,Latino,3,2,1,No meaningful results,,,,335,16,351
39860,"Red Wing, MN",46246,Micropolitan Statistical Area,Native American,5,4,1,No meaningful results,,,,335,16,351
39860,"Red Wing, MN",46246,Micropolitan Statistical Area,AAPI,1,1,0,No meaningful results,,,,335,16,351
25720,"Heber, UT",72811,Micropolitan Statistical Area,Black,5,5,0,No meaningful results,,,,906,82,988
25720,"Heber, UT",72811,Micropolitan Statistical Area,Latino,40,37,3,No meaningful results,,,,906,82,988
25720,"Heber, UT",72811,Micropolitan Statistical Area,Native American,1,1,0,No meaningful results,,,,906,82,988
25720,"Heber, UT",72811,Micropolitan Statistical Area,AAPI,14,14,0,No meaningful results,,,,906,82,988
37740,"Payson, AZ",53546,Micropolitan Statistical Area,Black,2,2,0,No meaningful results,,,,252,20,272
37740,"Payson, AZ",53546,Micropolitan Statistical Area,Latino,21,18,3,No meaningful results,,,,252,20,272
37740,"Payson, AZ",53546,Micropolitan Statistical Area,Native American,3,3,0,No meaningful results,,,,252,20,272
37740,"Payson, AZ",53546,Micropolitan Statistical Area,AAPI,3,3,0,No meaningful results,,,,252,20,272
48900,"Wilmington, NC",288337,Metropolitan Statistical Area,Black,85,74,11,Statistcially significant disparity,2.405465515,2.4,24,2583,145,2728
48900,"Wilmington, NC",288337,Metropolitan Statistical Area,Latino,73,68,5,Not statistcially significant,1.50061542,1.5,15,2583,145,2728
48900,"Wilmington, NC",288337,Metropolitan Statistical Area,Native American,9,9,0,Not statistcially significant,1.23E-86,0,0,2583,145,2728
48900,"Wilmington, NC",288337,Metropolitan Statistical Area,AAPI,65,62,3,Not statistcially significant,0.721538631,0.7,7,2583,145,2728
25540,"Hartford-East Hartford-Middletown, CT",1207677,Metropolitan Statistical Area,Black,455,409,46,No meaningful results,,,,5932,319,6251
25540,"Hartford-East Hartford-Middletown, CT",1207677,Metropolitan Statistical Area,Latino,550,487,63,No meaningful results,,,,5932,319,6251
25540,"Hartford-East Hartford-Middletown, CT",1207677,Metropolitan Statistical Area,Native American,21,19,2,No meaningful results,,,,5932,319,6251
25540,"Hartford-East Hartford-Middletown, CT",1207677,Metropolitan Statistical Area,AAPI,702,629,73,No meaningful results,,,,5932,319,6251
16260,"Cedar City, UT",51213,Micropolitan Statistical Area,Black,1,0,1,No meaningful results,,,,383,37,420
16260,"Cedar City, UT",51213,Micropolitan Statistical Area,Latino,17,14,3,No meaningful results,,,,383,37,420
16260,"Cedar City, UT",51213,Micropolitan Statistical Area,Native American,2,1,1,No meaningful results,,,,383,37,420
16260,"Cedar City, UT",51213,Micropolitan Statistical Area,AAPI,6,4,2,No meaningful results,,,,383,37,420
43420,"Sierra Vista-Douglas, AZ",125867,Metropolitan Statistical Area,Black,7,7,0,Regression equation needs to be tweaked,4.36E-09,0,0,381,28,409
43420,"Sierra Vista-Douglas, AZ",125867,Metropolitan Statistical Area,Latino,83,76,7,Regression equation needs to be tweaked,0.745511461,0.7,7,381,28,409
43420,"Sierra Vista-Douglas, AZ",125867,Metropolitan Statistical Area,Native American,3,1,2,Regression equation needs to be tweaked,333.2494408,333.2,3332,381,28,409
43420,"Sierra Vista-Douglas, AZ",125867,Metropolitan Statistical Area,AAPI,13,12,1,Regression equation needs to be tweaked,0.40956976,0.4,4,381,28,409
16500,"Centralia, WA",78145,Micropolitan Statistical Area,Black,6,6,0,No meaningful results,,,,412,30,442
16500,"Centralia, WA",78145,Micropolitan Statistical Area,Latino,24,23,1,No meaningful results,,,,412,30,442
16500,"Centralia, WA",78145,Micropolitan Statistical Area,Native American,6,5,1,No meaningful results,,,,412,30,442
16500,"Centralia, WA",78145,Micropolitan Statistical Area,AAPI,11,10,1,No meaningful results,,,,412,30,442
44060,"Spokane-Spokane Valley, WA",550160,Metropolitan Statistical Area,Black,61,51,10,Regression equation needs to be tweaked,2.202738926,2.2,22,4045,244,4289
44060,"Spokane-Spokane Valley, WA",550160,Metropolitan Statistical Area,Latino,195,181,14,Regression equation needs to be tweaked,1.114497589,1.1,11,4045,244,4289
44060,"Spokane-Spokane Valley, WA",550160,Metropolitan Statistical Area,Native American,45,42,3,Regression equation needs to be tweaked,0.798048396,0.8,8,4045,244,4289
44060,"Spokane-Spokane Valley, WA",550160,Metropolitan Statistical Area,AAPI,152,137,15,Regression equation needs to be tweaked,1.206573165,1.2,12,4045,244,4289
29620,"Lansing-East Lansing, MI",546772,Metropolitan Statistical Area,Black,122,111,11,Not statistcially significant,1.895092538,1.9,19,3342,123,3465
29620,"Lansing-East Lansing, MI",546772,Metropolitan Statistical Area,Latino,119,107,12,Statistcially significant disparity,2.394187173,2.4,24,3342,123,3465
29620,"Lansing-East Lansing, MI",546772,Metropolitan Statistical Area,Native American,16,13,3,Not enough of applications,7.666430655,7.7,77,3342,123,3465
29620,"Lansing-East Lansing, MI",546772,Metropolitan Statistical Area,AAPI,171,165,6,Not statistcially significant,0.898930329,0.9,9,3342,123,3465
36620,"Ontario, OR-ID",53672,Micropolitan Statistical Area,Black,0,0,0,No meaningful results,,,,260,21,281
36620,"Ontario, OR-ID",53672,Micropolitan Statistical Area,Latino,38,33,5,No meaningful results,,,,260,21,281
36620,"Ontario, OR-ID",53672,Micropolitan Statistical Area,Native American,1,1,0,No meaningful results,,,,260,21,281
36620,"Ontario, OR-ID",53672,Micropolitan Statistical Area,AAPI,3,3,0,No meaningful results,,,,260,21,281
14660,"Brainerd, MN",93485,Micropolitan Statistical Area,Black,3,2,1,No meaningful results,,,,486,45,531
14660,"Brainerd, MN",93485,Micropolitan Statistical Area,Latino,5,4,1,No meaningful results,,,,486,45,531
14660,"Brainerd, MN",93485,Micropolitan Statistical Area,Native American,3,1,2,No meaningful results,,,,486,45,531
14660,"Brainerd, MN",93485,Micropolitan Statistical Area,AAPI,4,3,1,No meaningful results,,,,486,45,531
37220,"Pahrump, NV",44380,Micropolitan Statistical Area,Black,7,5,2,No meaningful results,,,,204,27,231
37220,"Pahrump, NV",44380,Micropolitan Statistical Area,Latino,22,18,4,No meaningful results,,,,204,27,231
37220,"Pahrump, NV",44380,Micropolitan Statistical Area,Native American,2,2,0,No meaningful results,,,,204,27,231
37220,"Pahrump, NV",44380,Micropolitan Statistical Area,AAPI,8,7,1,No meaningful results,,,,204,27,231
20940,"El Centro, CA",180701,Metropolitan Statistical Area,Black,2,1,1,No meaningful results,,,,65,8,73
20940,"El Centro, CA",180701,Metropolitan Statistical Area,Latino,277,245,32,No meaningful results,,,,65,8,73
20940,"El Centro, CA",180701,Metropolitan Statistical Area,Native American,0,0,0,No meaningful results,,,,65,8,73
20940,"El Centro, CA",180701,Metropolitan Statistical Area,AAPI,9,8,1,No meaningful results,,,,65,8,73
31820,"Manitowoc, WI",79185,Micropolitan Statistical Area,Black,2,2,0,No meaningful results,,,,497,38,535
31820,"Manitowoc, WI",79185,Micropolitan Statistical Area,Latino,11,10,1,No meaningful results,,,,497,38,535
31820,"Manitowoc, WI",79185,Micropolitan Statistical Area,Native American,3,2,1,No meaningful results,,,,497,38,535
31820,"Manitowoc, WI",79185,Micropolitan Statistical Area,AAPI,11,9,2,No meaningful results,,,,497,38,535
26780,"Hutchinson, MN",35832,Micropolitan Statistical Area,Black,2,2,0,No meaningful results,,,,251,10,261
26780,"Hutchinson, MN",35832,Micropolitan Statistical Area,Latino,7,5,2,No meaningful results,,,,251,10,261
26780,"Hutchinson, MN",35832,Micropolitan Statistical Area,Native American,1,1,0,No meaningful results,,,,251,10,261
26780,"Hutchinson, MN",35832,Micropolitan Statistical Area,AAPI,1,1,0,No meaningful results,,,,251,10,261
31460,"Madera, CA",155433,Metropolitan Statistical Area,Black,14,14,0,No meaningful results,,,,350,16,366
31460,"Madera, CA",155433,Metropolitan Statistical Area,Latino,351,326,25,No meaningful results,,,,350,16,366
31460,"Madera, CA",155433,Metropolitan Statistical Area,Native American,7,7,0,No meaningful results,,,,350,16,366
31460,"Madera, CA",155433,Metropolitan Statistical Area,AAPI,42,41,1,No meaningful results,,,,350,16,366
22580,"Forest City, NC",66599,Micropolitan Statistical Area,Black,11,9,2,No meaningful results,,,,265,22,287
22580,"Forest City, NC",66599,Micropolitan Statistical Area,Latino,9,7,2,No meaningful results,,,,265,22,287
22580,"Forest City, NC",66599,Micropolitan Statistical Area,Native American,1,1,0,No meaningful results,,,,265,22,287
22580,"Forest City, NC",66599,Micropolitan Statistical Area,AAPI,3,3,0,No meaningful results,,,,265,22,287
22820,"Fort Morgan, CO",28517,Micropolitan Statistical Area,Black,3,3,0,No meaningful results,,,,111,3,114
22820,"Fort Morgan, CO",28517,Micropolitan Statistical Area,Latino,32,29,3,No meaningful results,,,,111,3,114
22820,"Fort Morgan, CO",28517,Micropolitan Statistical Area,Native American,0,0,0,No meaningful results,,,,111,3,114
22820,"Fort Morgan, CO",28517,Micropolitan Statistical Area,AAPI,5,3,2,No meaningful results,,,,111,3,114
12380,"Austin, MN",39807,Micropolitan Statistical Area,Black,9,8,1,No meaningful results,,,,198,8,206
12380,"Austin, MN",39807,Micropolitan Statistical Area,Latino,20,16,4,No meaningful results,,,,198,8,206
12380,"Austin, MN",39807,Micropolitan Statistical Area,Native American,1,1,0,No meaningful results,,,,198,8,206
12380,"Austin, MN",39807,Micropolitan Statistical Area,AAPI,28,28,0,No meaningful results,,,,198,8,206
38900,"Portland-Vancouver-Hillsboro, OR-WA",2445761,Metropolitan Statistical Area,Black,391,358,33,Regression equation needs to be tweaked,1.749269032,1.7,17,17270,711,17981
38900,"Portland-Vancouver-Hillsboro, OR-WA",2445761,Metropolitan Statistical Area,Latino,1415,1328,87,Regression equation needs to be tweaked,1.430837657,1.4,14,17270,711,17981
38900,"Portland-Vancouver-Hillsboro, OR-WA",2445761,Metropolitan Statistical Area,Native American,131,125,6,Regression equation needs to be tweaked,0.952131979,1,10,17270,711,17981
38900,"Portland-Vancouver-Hillsboro, OR-WA",2445761,Metropolitan Statistical Area,AAPI,2641,2446,195,Regression equation needs to be tweaked,1.833943891,1.8,18,17270,711,17981
22060,"Faribault-Northfield, MN",66185,Micropolitan Statistical Area,Black,5,4,1,No meaningful results,,,,365,24,389
22060,"Faribault-Northfield, MN",66185,Micropolitan Statistical Area,Latino,22,18,4,No meaningful results,,,,365,24,389
22060,"Faribault-Northfield, MN",66185,Micropolitan Statistical Area,Native American,4,4,0,No meaningful results,,,,365,24,389
22060,"Faribault-Northfield, MN",66185,Micropolitan Statistical Area,AAPI,6,6,0,No meaningful results,,,,365,24,389
10140,"Aberdeen, WA",72779,Micropolitan Statistical Area,Black,2,1,1,Regression equation needs to be tweaked,11.654962,11.7,117,341,22,363
10140,"Aberdeen, WA",72779,Micropolitan Statistical Area,Latino,16,15,1,Regression equation needs to be tweaked,2.228431321,2.2,22,341,22,363
10140,"Aberdeen, WA",72779,Micropolitan Statistical Area,Native American,5,5,0,Regression equation needs to be tweaked,2.16E-07,0,0,341,22,363
10140,"Aberdeen, WA",72779,Micropolitan Statistical Area,AAPI,10,9,1,Regression equation needs to be tweaked,3.351375184,3.4,34,341,22,363
42140,"Santa Fe, NM",149293,Metropolitan Statistical Area,Black,8,6,2,Regression equation needs to be tweaked,1.582635382,1.6,16,800,72,872
42140,"Santa Fe, NM",149293,Metropolitan Statistical Area,Latino,238,223,15,Regression equation needs to be tweaked,0.589646616,0.6,6,800,72,872
42140,"Santa Fe, NM",149293,Metropolitan Statistical Area,Native American,12,11,1,Regression equation needs to be tweaked,1.504123117,1.5,15,800,72,872
42140,"Santa Fe, NM",149293,Metropolitan Statistical Area,AAPI,26,23,3,Regression equation needs to be tweaked,1.09856056,1.1,11,800,72,872
43900,"Spartanburg, SC",307617,Metropolitan Statistical Area,Black,261,213,48,Not statistcially significant,1.212371642,1.2,12,2079,157,2236
43900,"Spartanburg, SC",307617,Metropolitan Statistical Area,Latino,173,149,24,Not statistcially significant,1.526702977,1.5,15,2079,157,2236
43900,"Spartanburg, SC",307617,Metropolitan Statistical Area,Native American,11,8,3,Not enough of applications,5.271819731,5.3,53,2079,157,2236
43900,"Spartanburg, SC",307617,Metropolitan Statistical Area,AAPI,113,103,10,Not statistcially significant,0.995592384,1,10,2079,157,2236
13720,"Big Stone Gap, VA",42456,Micropolitan Statistical Area,Black,1,1,0,No meaningful results,,,,63,11,74
13720,"Big Stone Gap, VA",42456,Micropolitan Statistical Area,Latino,1,0,1,No meaningful results,,,,63,11,74
13720,"Big Stone Gap, VA",42456,Micropolitan Statistical Area,Native American,0,0,0,No meaningful results,,,,63,11,74
13720,"Big Stone Gap, VA",42456,Micropolitan Statistical Area,AAPI,1,1,0,No meaningful results,,,,63,11,74
36940,"Owatonna, MN",36683,Micropolitan Statistical Area,Black,2,1,1,No meaningful results,,,,246,9,255
36940,"Owatonna, MN",36683,Micropolitan Statistical Area,Latino,11,9,2,No meaningful results,,,,246,9,255
36940,"Owatonna, MN",36683,Micropolitan Statistical Area,Native American,1,0,1,No meaningful results,,,,246,9,255
36940,"Owatonna, MN",36683,Micropolitan Statistical Area,AAPI,3,2,1,No meaningful results,,,,246,9,255
14580,"Bozeman, MT",108063,Micropolitan Statistical Area,Black,1,1,0,Regression equation needs to be tweaked,0.000671026,0,0,1169,42,1211
14580,"Bozeman, MT",108063,Micropolitan Statistical Area,Latino,35,34,1,Regression equation needs to be tweaked,1.923596607,1.9,19,1169,42,1211
14580,"Bozeman, MT",108063,Micropolitan Statistical Area,Native American,9,8,1,Regression equation needs to be tweaked,6.77507281,6.8,68,1169,42,1211
14580,"Bozeman, MT",108063,Micropolitan Statistical Area,AAPI,24,23,1,Regression equation needs to be tweaked,0.279185593,0.3,3,1169,42,1211
43320,"Show Low, AZ",109270,Micropolitan Statistical Area,Black,0,0,0,No meaningful results,,,,321,29,350
43320,"Show Low, AZ",109270,Micropolitan Statistical Area,Latino,22,18,4,No meaningful results,,,,321,29,350
43320,"Show Low, AZ",109270,Micropolitan Statistical Area,Native American,3,2,1,No meaningful results,,,,321,29,350
43320,"Show Low, AZ",109270,Micropolitan Statistical Area,AAPI,6,5,1,No meaningful results,,,,321,29,350
22660,"Fort Collins, CO",344786,Metropolitan Statistical Area,Black,25,24,1,No meaningful results,,,,3284,156,3440
22660,"Fort Collins, CO",344786,Metropolitan Statistical Area,Latino,203,191,12,No meaningful results,,,,3284,156,3440
22660,"Fort Collins, CO",344786,Metropolitan Statistical Area,Native American,13,12,1,No meaningful results,,,,3284,156,3440
22660,"Fort Collins, CO",344786,Metropolitan Statistical Area,AAPI,120,115,5,No meaningful results,,,,3284,156,3440
40420,"Rockford, IL",338356,Metropolitan Statistical Area,Black,76,69,7,Not statistcially significant,1.03200142,1,10,1563,102,1665
40420,"Rockford, IL",338356,Metropolitan Statistical Area,Latino,274,248,26,Not statistcially significant,0.762918764,0.8,8,1563,102,1665
40420,"Rockford, IL",338356,Metropolitan Statistical Area,Native American,4,2,2,Not statistcially significant,8.586722069,8.6,86,1563,102,1665
40420,"Rockford, IL",338356,Metropolitan Statistical Area,AAPI,79,76,3,Not statistcially significant,0.783217582,0.8,8,1563,102,1665
14740,"Bremerton-Silverdale-Port Orchard, WA",265882,Metropolitan Statistical Area,Black,26,24,2,Regression equation needs to be tweaked,0.845925376,0.8,8,1461,70,1531
14740,"Bremerton-Silverdale-Port Orchard, WA",265882,Metropolitan Statistical Area,Latino,77,70,7,Regression equation needs to be tweaked,1.746630488,1.7,17,1461,70,1531
14740,"Bremerton-Silverdale-Port Orchard, WA",265882,Metropolitan Statistical Area,Native American,12,11,1,Regression equation needs to be tweaked,3.992361445,4,40,1461,70,1531
14740,"Bremerton-Silverdale-Port Orchard, WA",265882,Metropolitan Statistical Area,AAPI,117,106,11,Regression equation needs to be tweaked,2.148638654,2.1,21,1461,70,1531
29420,"Lake Havasu City-Kingman, AZ",207695,Metropolitan Statistical Area,Black,11,10,1,No meaningful results,,,,1104,95,1199
29420,"Lake Havasu City-Kingman, AZ",207695,Metropolitan Statistical Area,Latino,102,86,16,No meaningful results,,,,1104,95,1199
29420,"Lake Havasu City-Kingman, AZ",207695,Metropolitan Statistical Area,Native American,9,6,3,No meaningful results,,,,1104,95,1199
29420,"Lake Havasu City-Kingman, AZ",207695,Metropolitan Statistical Area,AAPI,25,24,1,No meaningful results,,,,1104,95,1199
16940,"Cheyenne, WY",98320,Metropolitan Statistical Area,Black,5,5,0,No meaningful results,,,,632,24,656
16940,"Cheyenne, WY",98320,Metropolitan Statistical Area,Latino,62,61,1,No meaningful results,,,,632,24,656
16940,"Cheyenne, WY",98320,Metropolitan Statistical Area,Native American,1,1,0,No meaningful results,,,,632,24,656
16940,"Cheyenne, WY",98320,Metropolitan Statistical Area,AAPI,10,10,0,No meaningful results,,,,632,24,656
35440,"Newport, OR",48547,Micropolitan Statistical Area,Black,0,0,0,No meaningful results,,,,274,25,299
35440,"Newport, OR",48547,Micropolitan Statistical Area,Latino,14,12,2,No meaningful results,,,,274,25,299
35440,"Newport, OR",48547,Micropolitan Statistical Area,Native American,8,7,1,No meaningful results,,,,274,25,299
35440,"Newport, OR",48547,Micropolitan Statistical Area,AAPI,8,8,0,No meaningful results,,,,274,25,299
16180,"Carson City, NV",54773,Metropolitan Statistical Area,Black,2,1,1,No meaningful results,,,,319,7,326
16180,"Carson City, NV",54773,Metropolitan Statistical Area,Latino,61,59,2,No meaningful results,,,,319,7,326
16180,"Carson City, NV",54773,Metropolitan Statistical Area,Native American,4,2,2,No meaningful results,,,,319,7,326
16180,"Carson City, NV",54773,Metropolitan Statistical Area,AAPI,17,16,1,No meaningful results,,,,319,7,326
41420,"Salem, OR",422678,Metropolitan Statistical Area,Black,26,25,1,No meaningful results,,,,2524,130,2654
41420,"Salem, OR",422678,Metropolitan Statistical Area,Latino,434,391,43,No meaningful results,,,,2524,130,2654
41420,"Salem, OR",422678,Metropolitan Statistical Area,Native American,33,32,1,No meaningful results,,,,2524,130,2654
41420,"Salem, OR",422678,Metropolitan Statistical Area,AAPI,115,110,5,No meaningful results,,,,2524,130,2654
45220,"Tallahassee, FL",382197,Metropolitan Statistical Area,Black,238,192,46,Regression equation needs to be tweaked,1.812378583,1.8,18,1573,108,1681
45220,"Tallahassee, FL",382197,Metropolitan Statistical Area,Latino,117,107,10,Regression equation needs to be tweaked,0.530089613,0.5,5,1573,108,1681
45220,"Tallahassee, FL",382197,Metropolitan Statistical Area,Native American,7,5,2,Regression equation needs to be tweaked,10.4168291,10.4,104,1573,108,1681
45220,"Tallahassee, FL",382197,Metropolitan Statistical Area,AAPI,132,117,15,Regression equation needs to be tweaked,1.305907683,1.3,13,1573,108,1681
26740,"Hutchinson, KS",62765,Micropolitan Statistical Area,Black,2,2,0,No meaningful results,,,,200,11,211
26740,"Hutchinson, KS",62765,Micropolitan Statistical Area,Latino,6,6,0,No meaningful results,,,,200,11,211
26740,"Hutchinson, KS",62765,Micropolitan Statistical Area,Native American,1,1,0,No meaningful results,,,,200,11,211
26740,"Hutchinson, KS",62765,Micropolitan Statistical Area,AAPI,1,0,1,No meaningful results,,,,200,11,211
29660,"Laramie, WY",38390,Micropolitan Statistical Area,Black,2,2,0,No meaningful results,,,,211,9,220
29660,"Laramie, WY",38390,Micropolitan Statistical Area,Latino,6,6,0,No meaningful results,,,,211,9,220
29660,"Laramie, WY",38390,Micropolitan Statistical Area,Native American,2,2,0,No meaningful results,,,,211,9,220
29660,"Laramie, WY",38390,Micropolitan Statistical Area,AAPI,2,2,0,No meaningful results,,,,211,9,220
32700,"McPherson, KS",28567,Micropolitan Statistical Area,Black,0,0,0,No meaningful results,,,,79,6,85
32700,"McPherson, KS",28567,Micropolitan Statistical Area,Latino,1,1,0,No meaningful results,,,,79,6,85
32700,"McPherson, KS",28567,Micropolitan Statistical Area,Native American,1,1,0,No meaningful results,,,,79,6,85
32700,"McPherson, KS",28567,Micropolitan Statistical Area,AAPI,1,1,0,No meaningful results,,,,79,6,85
42034,"San Rafael, CA",259943,Metropolitan Division,Black,16,16,0,Regression equation needs to be tweaked,9.39E-14,0,0,1378,68,1446
42034,"San Rafael, CA",259943,Metropolitan Division,Latino,116,105,11,Regression equation needs to be tweaked,1.593950469,1.6,16,1378,68,1446
42034,"San Rafael, CA",259943,Metropolitan Division,Native American,5,5,0,Regression equation needs to be tweaked,3.46E-08,0,0,1378,68,1446
42034,"San Rafael, CA",259943,Metropolitan Division,AAPI,152,144,8,Regression equation needs to be tweaked,1.072789442,1.1,11,1378,68,1446
36020,"Oak Harbor, WA",82866,Micropolitan Statistical Area,Black,6,6,0,No meaningful results,,,,560,37,597
36020,"Oak Harbor, WA",82866,Micropolitan Statistical Area,Latino,17,16,1,No meaningful results,,,,560,37,597
36020,"Oak Harbor, WA",82866,Micropolitan Statistical Area,Native American,9,8,1,No meaningful results,,,,560,37,597
36020,"Oak Harbor, WA",82866,Micropolitan Statistical Area,AAPI,23,23,0,No meaningful results,,,,560,37,597
12220,"Auburn-Opelika, AL",161152,Metropolitan Statistical Area,Black,87,76,11,No meaningful results,,,,923,23,946
12220,"Auburn-Opelika, AL",161152,Metropolitan Statistical Area,Latino,25,23,2,No meaningful results,,,,923,23,946
12220,"Auburn-Opelika, AL",161152,Metropolitan Statistical Area,Native American,5,5,0,No meaningful results,,,,923,23,946
12220,"Auburn-Opelika, AL",161152,Metropolitan Statistical Area,AAPI,106,100,6,No meaningful results,,,,923,23,946
23860,"Georgetown, SC",61952,Micropolitan Statistical Area,Black,15,11,4,No meaningful results,,,,372,22,394
23860,"Georgetown, SC",61952,Micropolitan Statistical Area,Latino,2,2,0,No meaningful results,,,,372,22,394
23860,"Georgetown, SC",61952,Micropolitan Statistical Area,Native American,1,1,0,No meaningful results,,,,372,22,394
23860,"Georgetown, SC",61952,Micropolitan Statistical Area,AAPI,1,0,1,No meaningful results,,,,372,22,394
43760,"Sonora, CA",54045,Micropolitan Statistical Area,Black,1,1,0,No meaningful results,,,,231,21,252
43760,"Sonora, CA",54045,Micropolitan Statistical Area,Latino,13,12,1,No meaningful results,,,,231,21,252
43760,"Sonora, CA",54045,Micropolitan Statistical Area,Native American,3,3,0,No meaningful results,,,,231,21,252
43760,"Sonora, CA",54045,Micropolitan Statistical Area,AAPI,8,7,1,No meaningful results,,,,231,21,252
19940,"Dixon, IL",34389,Micropolitan Statistical Area,Black,0,0,0,No meaningful results,,,,61,2,63
19940,"Dixon, IL",34389,Micropolitan Statistical Area,Latino,1,1,0,No meaningful results,,,,61,2,63
19940,"Dixon, IL",34389,Micropolitan Statistical Area,Native American,0,0,0,No meaningful results,,,,61,2,63
19940,"Dixon, IL",34389,Micropolitan Statistical Area,AAPI,0,0,0,No meaningful results,,,,61,2,63
32000,"Marion, NC",45227,Micropolitan Statistical Area,Black,1,1,0,No meaningful results,,,,187,10,197
32000,"Marion, NC",45227,Micropolitan Statistical Area,Latino,4,4,0,No meaningful results,,,,187,10,197
32000,"Marion, NC",45227,Micropolitan Statistical Area,Native American,2,2,0,No meaningful results,,,,187,10,197
32000,"Marion, NC",45227,Micropolitan Statistical Area,AAPI,2,2,0,No meaningful results,,,,187,10,197
42020,"San Luis Obispo-Paso Robles, CA",282165,Metropolitan Statistical Area,Black,9,9,0,No meaningful results,,,,1337,85,1422
42020,"San Luis Obispo-Paso Robles, CA",282165,Metropolitan Statistical Area,Latino,175,168,7,No meaningful results,,,,1337,85,1422
42020,"San Luis Obispo-Paso Robles, CA",282165,Metropolitan Statistical Area,Native American,4,3,1,No meaningful results,,,,1337,85,1422
42020,"San Luis Obispo-Paso Robles, CA",282165,Metropolitan Statistical Area,AAPI,75,69,6,No meaningful results,,,,1337,85,1422
24330,"Grand Rapids, MN",45141,Micropolitan Statistical Area,Black,1,1,0,No meaningful results,,,,210,55,265
24330,"Grand Rapids, MN",45141,Micropolitan Statistical Area,Latino,5,2,3,No meaningful results,,,,210,55,265
24330,"Grand Rapids, MN",45141,Micropolitan Statistical Area,Native American,4,1,3,No meaningful results,,,,210,55,265
24330,"Grand Rapids, MN",45141,Micropolitan Statistical Area,AAPI,2,2,0,No meaningful results,,,,210,55,265
49340,"Worcester, MA-CT",941338,Metropolitan Statistical Area,Black,245,219,26,Regression equation needs to be tweaked,1.991171205,2,20,4659,217,4876
49340,"Worcester, MA-CT",941338,Metropolitan Statistical Area,Latino,604,537,67,Regression equation needs to be tweaked,1.678874853,1.7,17,4659,217,4876
49340,"Worcester, MA-CT",941338,Metropolitan Statistical Area,Native American,17,15,2,Regression equation needs to be tweaked,2.154874278,2.2,22,4659,217,4876
49340,"Worcester, MA-CT",941338,Metropolitan Statistical Area,AAPI,528,477,51,Regression equation needs to be tweaked,1.974348577,2,20,4659,217,4876
22380,"Flagstaff, AZ",141274,Metropolitan Statistical Area,Black,2,2,0,No meaningful results,,,,619,36,655
22380,"Flagstaff, AZ",141274,Metropolitan Statistical Area,Latino,75,67,8,No meaningful results,,,,619,36,655
22380,"Flagstaff, AZ",141274,Metropolitan Statistical Area,Native American,15,14,1,No meaningful results,,,,619,36,655
22380,"Flagstaff, AZ",141274,Metropolitan Statistical Area,AAPI,26,24,2,No meaningful results,,,,619,36,655
35300,"New Haven-Milford, CT",857513,Metropolitan Statistical Area,Black,313,263,50,Statistcially significant disparity,2.533404589,2.5,25,3431,203,3634
35300,"New Haven-Milford, CT",857513,Metropolitan Statistical Area,Latino,599,526,73,Statistcially significant disparity,1.552647286,1.6,16,3431,203,3634
35300,"New Haven-Milford, CT",857513,Metropolitan Statistical Area,Native American,16,14,2,Not statistcially significant,3.211653342,3.2,32,3431,203,3634
35300,"New Haven-Milford, CT",857513,Metropolitan Statistical Area,AAPI,246,220,26,Not statistcially significant,1.637480649,1.6,16,3431,203,3634
49740,"Yuma, AZ",209468,Metropolitan Statistical Area,Black,6,5,1,No meaningful results,,,,340,12,352
49740,"Yuma, AZ",209468,Metropolitan Statistical Area,Latino,388,362,26,No meaningful results,,,,340,12,352
49740,"Yuma, AZ",209468,Metropolitan Statistical Area,Native American,5,5,0,No meaningful results,,,,340,12,352
49740,"Yuma, AZ",209468,Metropolitan Statistical Area,AAPI,23,22,1,No meaningful results,,,,340,12,352
22840,"Fort Payne, AL",71310,Micropolitan Statistical Area,Black,0,0,0,No meaningful results,,,,136,12,148
22840,"Fort Payne, AL",71310,Micropolitan Statistical Area,Latino,5,3,2,No meaningful results,,,,136,12,148
22840,"Fort Payne, AL",71310,Micropolitan Statistical Area,Native American,3,3,0,No meaningful results,,,,136,12,148
22840,"Fort Payne, AL",71310,Micropolitan Statistical Area,AAPI,2,2,0,No meaningful results,,,,136,12,148
33300,"Milledgeville, GA",53626,Micropolitan Statistical Area,Black,15,13,2,No meaningful results,,,,103,2,105
33300,"Milledgeville, GA",53626,Micropolitan Statistical Area,Latino,3,3,0,No meaningful results,,,,103,2,105
33300,"Milledgeville, GA",53626,Micropolitan Statistical Area,Native American,0,0,0,No meaningful results,,,,103,2,105
33300,"Milledgeville, GA",53626,Micropolitan Statistical Area,AAPI,3,3,0,No meaningful results,,,,103,2,105
35980,"Norwich-New London, CT",267390,Metropolitan Statistical Area,Black,39,37,2,Regression equation needs to be tweaked,1.01526727,1,10,1244,82,1326
35980,"Norwich-New London, CT",267390,Metropolitan Statistical Area,Latino,96,85,11,Regression equation needs to be tweaked,2.660480949,2.7,27,1244,82,1326
35980,"Norwich-New London, CT",267390,Metropolitan Statistical Area,Native American,11,10,1,Regression equation needs to be tweaked,2.214912755,2.2,22,1244,82,1326
35980,"Norwich-New London, CT",267390,Metropolitan Statistical Area,AAPI,65,58,7,Regression equation needs to be tweaked,2.313548475,2.3,23,1244,82,1326
20260,"Duluth, MN-WI",289247,Metropolitan Statistical Area,Black,12,10,2,Not statistcially significant,0.493433449,0.5,5,1755,117,1872
20260,"Duluth, MN-WI",289247,Metropolitan Statistical Area,Latino,21,19,2,Not statistcially significant,1.4783153,1.5,15,1755,117,1872
20260,"Duluth, MN-WI",289247,Metropolitan Statistical Area,Native American,16,13,3,Not enough of applications,4.220520124,4.2,42,1755,117,1872
20260,"Duluth, MN-WI",289247,Metropolitan Statistical Area,AAPI,15,14,1,Not statistcially significant,1.361913349,1.4,14,1755,117,1872
19300,"Daphne-Fairhope-Foley, AL",212830,Metropolitan Statistical Area,Black,30,28,2,No meaningful results,,,,2150,108,2258
19300,"Daphne-Fairhope-Foley, AL",212830,Metropolitan Statistical Area,Latino,38,36,2,No meaningful results,,,,2150,108,2258
19300,"Daphne-Fairhope-Foley, AL",212830,Metropolitan Statistical Area,Native American,11,10,1,No meaningful results,,,,2150,108,2258
19300,"Daphne-Fairhope-Foley, AL",212830,Metropolitan Statistical Area,AAPI,31,29,2,No meaningful results,,,,2150,108,2258
14454,"Boston, MA",2012345,Metropolitan Division,Black,792,712,80,Statistcially significant disparity,1.826663594,1.8,18,10311,469,10780
14454,"Boston, MA",2012345,Metropolitan Division,Latino,753,690,63,Statistcially significant disparity,1.669317485,1.7,17,10311,469,10780
14454,"Boston, MA",2012345,Metropolitan Division,Native American,25,23,2,Not statistcially significant,1.325214113,1.3,13,10311,469,10780
14454,"Boston, MA",2012345,Metropolitan Division,AAPI,1724,1598,126,Statistcially significant disparity,1.50064292,1.5,15,10311,469,10780
13740,"Billings, MT",179071,Metropolitan Statistical Area,Black,6,5,1,No meaningful results,,,,1309,54,1363
13740,"Billings, MT",179071,Metropolitan Statistical Area,Latino,32,32,0,No meaningful results,,,,1309,54,1363
13740,"Billings, MT",179071,Metropolitan Statistical Area,Native American,8,8,0,No meaningful results,,,,1309,54,1363
13740,"Billings, MT",179071,Metropolitan Statistical Area,AAPI,15,15,0,No meaningful results,,,,1309,54,1363
23540,"Gainesville, FL",323799,Metropolitan Statistical Area,Black,75,64,11,No meaningful results,,,,1638,102,1740
23540,"Gainesville, FL",323799,Metropolitan Statistical Area,Latino,206,184,22,No meaningful results,,,,1638,102,1740
23540,"Gainesville, FL",323799,Metropolitan Statistical Area,Native American,9,8,1,No meaningful results,,,,1638,102,1740
23540,"Gainesville, FL",323799,Metropolitan Statistical Area,AAPI,170,153,17,No meaningful results,,,,1638,102,1740
20420,"Durango, CO",55617,Micropolitan Statistical Area,Black,1,1,0,No meaningful results,,,,480,29,509
20420,"Durango, CO",55617,Micropolitan Statistical Area,Latino,18,17,1,No meaningful results,,,,480,29,509
20420,"Durango, CO",55617,Micropolitan Statistical Area,Native American,7,7,0,No meaningful results,,,,480,29,509
20420,"Durango, CO",55617,Micropolitan Statistical Area,AAPI,5,5,0,No meaningful results,,,,480,29,509
31700,"Manchester-Nashua, NH",413035,Metropolitan Statistical Area,Black,43,32,11,Not enough of applications,5.214281823,5.2,52,3073,190,3263
31700,"Manchester-Nashua, NH",413035,Metropolitan Statistical Area,Latino,147,126,21,Statistcially significant disparity,2.32389027,2.3,23,3073,190,3263
31700,"Manchester-Nashua, NH",413035,Metropolitan Statistical Area,Native American,7,6,1,Not statistcially significant,2.320013561,2.3,23,3073,190,3263
31700,"Manchester-Nashua, NH",413035,Metropolitan Statistical Area,AAPI,182,159,23,Statistcially significant disparity,2.130002584,2.1,21,3073,190,3263
25860,"Hickory-Lenoir-Morganton, NC",366678,Metropolitan Statistical Area,Black,42,39,3,No meaningful results,,,,1820,99,1919
25860,"Hickory-Lenoir-Morganton, NC",366678,Metropolitan Statistical Area,Latino,109,101,8,No meaningful results,,,,1820,99,1919
25860,"Hickory-Lenoir-Morganton, NC",366678,Metropolitan Statistical Area,Native American,7,7,0,No meaningful results,,,,1820,99,1919
25860,"Hickory-Lenoir-Morganton, NC",366678,Metropolitan Statistical Area,AAPI,79,66,13,No meaningful results,,,,1820,99,1919
27980,"Kahului-Wailuku-Lahaina, HI",165979,Metropolitan Statistical Area,Black,8,7,1,Regression equation needs to be tweaked,0.292787169,0.3,3,457,31,488
27980,"Kahului-Wailuku-Lahaina, HI",165979,Metropolitan Statistical Area,Latino,51,48,3,Regression equation needs to be tweaked,0.75051495,0.8,8,457,31,488
27980,"Kahului-Wailuku-Lahaina, HI",165979,Metropolitan Statistical Area,Native American,8,7,1,Regression equation needs to be tweaked,2.648656803,2.6,26,457,31,488
27980,"Kahului-Wailuku-Lahaina, HI",165979,Metropolitan Statistical Area,AAPI,260,243,17,Regression equation needs to be tweaked,0.791331083,0.8,8,457,31,488
21260,"Ellensburg, WA",45897,Micropolitan Statistical Area,Black,2,2,0,No meaningful results,,,,340,30,370
21260,"Ellensburg, WA",45897,Micropolitan Statistical Area,Latino,16,16,0,No meaningful results,,,,340,30,370
21260,"Ellensburg, WA",45897,Micropolitan Statistical Area,Native American,5,5,0,No meaningful results,,,,340,30,370
21260,"Ellensburg, WA",45897,Micropolitan Statistical Area,AAPI,3,3,0,No meaningful results,,,,340,30,370
39300,"Providence-Warwick, RI-MA",1618268,Metropolitan Statistical Area,Black,370,327,43,Statistcially significant disparity,1.696135246,1.7,17,8602,470,9072
39300,"Providence-Warwick, RI-MA",1618268,Metropolitan Statistical Area,Latino,666,596,70,Statistcially significant disparity,1.704870663,1.7,17,8602,470,9072
39300,"Providence-Warwick, RI-MA",1618268,Metropolitan Statistical Area,Native American,20,16,4,Not statistcially significant,1.464189118,1.5,15,8602,470,9072
39300,"Providence-Warwick, RI-MA",1618268,Metropolitan Statistical Area,AAPI,393,357,36,Statistcially significant disparity,1.799162865,1.8,18,8602,470,9072
34180,"Moses Lake, WA",95502,Micropolitan Statistical Area,Black,7,7,0,Regression equation needs to be tweaked,1.46E-12,0,0,338,18,356
34180,"Moses Lake, WA",95502,Micropolitan Statistical Area,Latino,108,94,14,Regression equation needs to be tweaked,1.808042638,1.8,18,338,18,356
34180,"Moses Lake, WA",95502,Micropolitan Statistical Area,Native American,7,6,1,Regression equation needs to be tweaked,0.769434325,0.8,8,338,18,356
34180,"Moses Lake, WA",95502,Micropolitan Statistical Area,AAPI,10,10,0,Regression equation needs to be tweaked,0.001215442,0,0,338,18,356
24180,"Granbury, TX",58318,Micropolitan Statistical Area,Black,1,0,1,No meaningful results,,,,457,22,479
24180,"Granbury, TX",58318,Micropolitan Statistical Area,Latino,24,22,2,No meaningful results,,,,457,22,479
24180,"Granbury, TX",58318,Micropolitan Statistical Area,Native American,2,1,1,No meaningful results,,,,457,22,479
24180,"Granbury, TX",58318,Micropolitan Statistical Area,AAPI,8,8,0,No meaningful results,,,,457,22,479
13420,"Bemidji, MN",46403,Micropolitan Statistical Area,Black,0,0,0,No meaningful results,,,,110,41,151
13420,"Bemidji, MN",46403,Micropolitan Statistical Area,Latino,2,1,1,No meaningful results,,,,110,41,151
13420,"Bemidji, MN",46403,Micropolitan Statistical Area,Native American,6,2,4,No meaningful results,,,,110,41,151
13420,"Bemidji, MN",46403,Micropolitan Statistical Area,AAPI,3,2,1,No meaningful results,,,,110,41,151
28420,"Kennewick-Richland, WA",289527,Metropolitan Statistical Area,Black,11,11,0,Regression equation needs to be tweaked,7.49E-08,0,0,2103,70,2173
28420,"Kennewick-Richland, WA",289527,Metropolitan Statistical Area,Latino,546,521,25,Regression equation needs to be tweaked,0.851754776,0.9,9,2103,70,2173
28420,"Kennewick-Richland, WA",289527,Metropolitan Statistical Area,Native American,20,19,1,Regression equation needs to be tweaked,2.1103173,2.1,21,2103,70,2173
28420,"Kennewick-Richland, WA",289527,Metropolitan Statistical Area,AAPI,120,114,6,Regression equation needs to be tweaked,0.88494745,0.9,9,2103,70,2173
44140,"Springfield, MA",699480,Metropolitan Statistical Area,Black,157,139,18,No meaningful results,,,,2874,163,3037
44140,"Springfield, MA",699480,Metropolitan Statistical Area,Latino,389,352,37,No meaningful results,,,,2874,163,3037
44140,"Springfield, MA",699480,Metropolitan Statistical Area,Native American,9,8,1,No meaningful results,,,,2874,163,3037
44140,"Springfield, MA",699480,Metropolitan Statistical Area,AAPI,171,152,19,No meaningful results,,,,2874,163,3037
13460,"Bend, OR",186251,Metropolitan Statistical Area,Black,5,5,0,No meaningful results,,,,2208,110,2318
13460,"Bend, OR",186251,Metropolitan Statistical Area,Latino,66,61,5,No meaningful results,,,,2208,110,2318
13460,"Bend, OR",186251,Metropolitan Statistical Area,Native American,13,13,0,No meaningful results,,,,2208,110,2318
13460,"Bend, OR",186251,Metropolitan Statistical Area,AAPI,41,37,4,No meaningful results,,,,2208,110,2318
44100,"Springfield, IL",209167,Metropolitan Statistical Area,Black,67,60,7,No meaningful results,,,,1654,53,1707
44100,"Springfield, IL",209167,Metropolitan Statistical Area,Latino,39,37,2,No meaningful results,,,,1654,53,1707
44100,"Springfield, IL",209167,Metropolitan Statistical Area,Native American,7,7,0,No meaningful results,,,,1654,53,1707
44100,"Springfield, IL",209167,Metropolitan Statistical Area,AAPI,65,62,3,No meaningful results,,,,1654,53,1707
31140,"Louisville/Jefferson County, KY-IN",1257088,Metropolitan Statistical Area,Black,505,459,46,Regression equation needs to be tweaked,1.714269673,1.7,17,8012,417,8429
31140,"Louisville/Jefferson County, KY-IN",1257088,Metropolitan Statistical Area,Latino,559,503,56,Regression equation needs to be tweaked,1.127923735,1.1,11,8012,417,8429
31140,"Louisville/Jefferson County, KY-IN",1257088,Metropolitan Statistical Area,Native American,20,17,3,Regression equation needs to be tweaked,2.656634106,2.7,27,8012,417,8429
31140,"Louisville/Jefferson County, KY-IN",1257088,Metropolitan Statistical Area,AAPI,370,343,27,Regression equation needs to be tweaked,1.597465986,1.6,16,8012,417,8429
30460,"Lexington-Fayette, KY",510647,Metropolitan Statistical Area,Black,169,157,12,Regression equation needs to be tweaked,1.475328501,1.5,15,3447,140,3587
30460,"Lexington-Fayette, KY",510647,Metropolitan Statistical Area,Latino,195,177,18,Regression equation needs to be tweaked,1.717698077,1.7,17,3447,140,3587
30460,"Lexington-Fayette, KY",510647,Metropolitan Statistical Area,Native American,3,2,1,Regression equation needs to be tweaked,11.5423625,11.5,115,3447,140,3587
30460,"Lexington-Fayette, KY",510647,Metropolitan Statistical Area,AAPI,188,176,12,Regression equation needs to be tweaked,1.451686676,1.5,15,3447,140,3587
40080,"Richmond-Berea, KY",105026,Micropolitan Statistical Area,Black,9,9,0,No meaningful results,,,,542,21,563
40080,"Richmond-Berea, KY",105026,Micropolitan Statistical Area,Latino,13,11,2,No meaningful results,,,,542,21,563
40080,"Richmond-Berea, KY",105026,Micropolitan Statistical Area,Native American,2,2,0,No meaningful results,,,,542,21,563
40080,"Richmond-Berea, KY",105026,Micropolitan Statistical Area,AAPI,9,9,0,No meaningful results,,,,542,21,563
48580,"Whitewater, WI",103074,Micropolitan Statistical Area,Black,1,1,0,No meaningful results,,,,763,50,813
48580,"Whitewater, WI",103074,Micropolitan Statistical Area,Latino,43,40,3,No meaningful results,,,,763,50,813
48580,"Whitewater, WI",103074,Micropolitan Statistical Area,Native American,1,1,0,No meaningful results,,,,763,50,813
48580,"Whitewater, WI",103074,Micropolitan Statistical Area,AAPI,8,8,0,No meaningful results,,,,763,50,813
14540,"Bowling Green, KY",174498,Metropolitan Statistical Area,Black,29,29,0,No meaningful results,,,,839,64,903
14540,"Bowling Green, KY",174498,Metropolitan Statistical Area,Latino,31,28,3,No meaningful results,,,,839,64,903
14540,"Bowling Green, KY",174498,Metropolitan Statistical Area,Native American,1,1,0,No meaningful results,,,,839,64,903
14540,"Bowling Green, KY",174498,Metropolitan Statistical Area,AAPI,83,77,6,No meaningful results,,,,839,64,903
28500,"Kerrville, TX",51843,Micropolitan Statistical Area,Black,0,0,0,No meaningful results,,,,188,12,200
28500,"Kerrville, TX",51843,Micropolitan Statistical Area,Latino,25,23,2,No meaningful results,,,,188,12,200
28500,"Kerrville, TX",51843,Micropolitan Statistical Area,Native American,1,1,0,No meaningful results,,,,188,12,200
28500,"Kerrville, TX",51843,Micropolitan Statistical Area,AAPI,5,5,0,No meaningful results,,,,188,12,200
12680,"Bardstown, KY",45650,Micropolitan Statistical Area,Black,0,0,0,No meaningful results,,,,189,18,207
12680,"Bardstown, KY",45650,Micropolitan Statistical Area,Latino,4,2,2,No meaningful results,,,,189,18,207
12680,"Bardstown, KY",45650,Micropolitan Statistical Area,Native American,0,0,0,No meaningful results,,,,189,18,207
12680,"Bardstown, KY",45650,Micropolitan Statistical Area,AAPI,0,0,0,No meaningful results,,,,189,18,207
40484,"Rockingham County-Strafford County, NH",435483,Metropolitan Division,Black,25,21,4,No meaningful results,,,,3543,189,3732
40484,"Rockingham County-Strafford County, NH",435483,Metropolitan Division,Latino,99,88,11,No meaningful results,,,,3543,189,3732
40484,"Rockingham County-Strafford County, NH",435483,Metropolitan Division,Native American,9,8,1,No meaningful results,,,,3543,189,3732
40484,"Rockingham County-Strafford County, NH",435483,Metropolitan Division,AAPI,105,92,13,No meaningful results,,,,3543,189,3732
23180,"Frankfort, KY",72938,Micropolitan Statistical Area,Black,9,5,4,No meaningful results,,,,373,24,397
23180,"Frankfort, KY",72938,Micropolitan Statistical Area,Latino,9,7,2,No meaningful results,,,,373,24,397
23180,"Frankfort, KY",72938,Micropolitan Statistical Area,Native American,2,2,0,No meaningful results,,,,373,24,397
23180,"Frankfort, KY",72938,Micropolitan Statistical Area,AAPI,7,7,0,No meaningful results,,,,373,24,397
18260,"Cookeville, TN",111197,Micropolitan Statistical Area,Black,2,2,0,No meaningful results,,,,441,17,458
18260,"Cookeville, TN",111197,Micropolitan Statistical Area,Latino,17,17,0,No meaningful results,,,,441,17,458
18260,"Cookeville, TN",111197,Micropolitan Statistical Area,Native American,3,3,0,No meaningful results,,,,441,17,458
18260,"Cookeville, TN",111197,Micropolitan Statistical Area,AAPI,10,10,0,No meaningful results,,,,441,17,458
43220,"Shelton, WA",63804,Micropolitan Statistical Area,Black,4,3,1,No meaningful results,,,,300,20,320
43220,"Shelton, WA",63804,Micropolitan Statistical Area,Latino,26,24,2,No meaningful results,,,,300,20,320
43220,"Shelton, WA",63804,Micropolitan Statistical Area,Native American,10,10,0,No meaningful results,,,,300,20,320
43220,"Shelton, WA",63804,Micropolitan Statistical Area,AAPI,16,12,4,No meaningful results,,,,300,20,320
10620,"Albemarle, NC",61588,Micropolitan Statistical Area,Black,21,19,2,No meaningful results,,,,403,22,425
10620,"Albemarle, NC",61588,Micropolitan Statistical Area,Latino,15,13,2,No meaningful results,,,,403,22,425
10620,"Albemarle, NC",61588,Micropolitan Statistical Area,Native American,1,1,0,No meaningful results,,,,403,22,425
10620,"Albemarle, NC",61588,Micropolitan Statistical Area,AAPI,7,6,1,No meaningful results,,,,403,22,425
20220,"Dubuque, IA",96982,Metropolitan Statistical Area,Black,8,8,0,No meaningful results,,,,881,41,922
20220,"Dubuque, IA",96982,Metropolitan Statistical Area,Latino,16,14,2,No meaningful results,,,,881,41,922
20220,"Dubuque, IA",96982,Metropolitan Statistical Area,Native American,0,0,0,No meaningful results,,,,881,41,922
20220,"Dubuque, IA",96982,Metropolitan Statistical Area,AAPI,10,9,1,No meaningful results,,,,881,41,922
46140,"Tulsa, OK",990544,Metropolitan Statistical Area,Black,155,133,22,Statistcially significant disparity,2.155306138,2.2,22,4754,239,4993
46140,"Tulsa, OK",990544,Metropolitan Statistical Area,Latino,612,568,44,Not statistcially significant,0.92626552,0.9,9,4754,239,4993
46140,"Tulsa, OK",990544,Metropolitan Statistical Area,Native American,419,399,20,Not statistcially significant,0.909193857,0.9,9,4754,239,4993
46140,"Tulsa, OK",990544,Metropolitan Statistical Area,AAPI,298,274,24,Not statistcially significant,1.544550738,1.5,15,4754,239,4993
47300,"Visalia, CA",461898,Metropolitan Statistical Area,Black,11,11,0,Regression equation needs to be tweaked,1.05E-09,0,0,733,39,772
47300,"Visalia, CA",461898,Metropolitan Statistical Area,Latino,772,721,51,Regression equation needs to be tweaked,0.852870229,0.9,9,733,39,772
47300,"Visalia, CA",461898,Metropolitan Statistical Area,Native American,3,3,0,Regression equation needs to be tweaked,2.80E-05,0,0,733,39,772
47300,"Visalia, CA",461898,Metropolitan Statistical Area,AAPI,97,89,8,Regression equation needs to be tweaked,1.110875765,1.1,11,733,39,772
14820,"Brevard, NC",33775,Micropolitan Statistical Area,Black,5,4,1,No meaningful results,,,,200,21,221
14820,"Brevard, NC",33775,Micropolitan Statistical Area,Latino,8,7,1,No meaningful results,,,,200,21,221
14820,"Brevard, NC",33775,Micropolitan Statistical Area,Native American,0,0,0,No meaningful results,,,,200,21,221
14820,"Brevard, NC",33775,Micropolitan Statistical Area,AAPI,4,3,1,No meaningful results,,,,200,21,221
38860,"Portland-South Portland, ME",532075,Metropolitan Statistical Area,Black,40,37,3,Regression equation needs to be tweaked,0.80855884,0.8,8,3646,203,3849
38860,"Portland-South Portland, ME",532075,Metropolitan Statistical Area,Latino,41,36,5,Regression equation needs to be tweaked,2.131223089,2.1,21,3646,203,3849
38860,"Portland-South Portland, ME",532075,Metropolitan Statistical Area,Native American,6,5,1,Regression equation needs to be tweaked,1.513641763,1.5,15,3646,203,3849
38860,"Portland-South Portland, ME",532075,Metropolitan Statistical Area,AAPI,115,107,8,Regression equation needs to be tweaked,1.103797798,1.1,11,3646,203,3849
39820,"Redding, CA",179212,Metropolitan Statistical Area,Black,11,9,2,No meaningful results,,,,922,49,971
39820,"Redding, CA",179212,Metropolitan Statistical Area,Latino,66,62,4,No meaningful results,,,,922,49,971
39820,"Redding, CA",179212,Metropolitan Statistical Area,Native American,25,24,1,No meaningful results,,,,922,49,971
39820,"Redding, CA",179212,Metropolitan Statistical Area,AAPI,42,40,2,No meaningful results,,,,922,49,971
18300,"Coos Bay, OR",63686,Micropolitan Statistical Area,Black,1,1,0,No meaningful results,,,,259,24,283
18300,"Coos Bay, OR",63686,Micropolitan Statistical Area,Latino,9,9,0,No meaningful results,,,,259,24,283
18300,"Coos Bay, OR",63686,Micropolitan Statistical Area,Native American,4,4,0,No meaningful results,,,,259,24,283
18300,"Coos Bay, OR",63686,Micropolitan Statistical Area,AAPI,7,7,0,No meaningful results,,,,259,24,283
49420,"Yakima, WA",249697,Metropolitan Statistical Area,Black,3,3,0,No meaningful results,,,,732,28,760
49420,"Yakima, WA",249697,Metropolitan Statistical Area,Latino,427,402,25,No meaningful results,,,,732,28,760
49420,"Yakima, WA",249697,Metropolitan Statistical Area,Native American,13,13,0,No meaningful results,,,,732,28,760
49420,"Yakima, WA",249697,Metropolitan Statistical Area,AAPI,27,26,1,No meaningful results,,,,732,28,760
43940,"Spearfish, SD",25478,Micropolitan Statistical Area,Black,1,1,0,No meaningful results,,,,127,10,137
43940,"Spearfish, SD",25478,Micropolitan Statistical Area,Latino,3,3,0,No meaningful results,,,,127,10,137
43940,"Spearfish, SD",25478,Micropolitan Statistical Area,Native American,2,2,0,No meaningful results,,,,127,10,137
43940,"Spearfish, SD",25478,Micropolitan Statistical Area,AAPI,1,1,0,No meaningful results,,,,127,10,137
19000,"Cullowhee, NC",57198,Micropolitan Statistical Area,Black,2,2,0,No meaningful results,,,,210,29,239
19000,"Cullowhee, NC",57198,Micropolitan Statistical Area,Latino,5,4,1,No meaningful results,,,,210,29,239
19000,"Cullowhee, NC",57198,Micropolitan Statistical Area,Native American,16,12,4,No meaningful results,,,,210,29,239
19000,"Cullowhee, NC",57198,Micropolitan Statistical Area,AAPI,1,1,0,No meaningful results,,,,210,29,239
41180,"St. Louis, MO-IL",2805190,Metropolitan Statistical Area,Black,1085,932,153,Statistcially significant disparity,1.743120598,1.7,17,18764,772,19536
41180,"St. Louis, MO-IL",2805190,Metropolitan Statistical Area,Latino,576,529,47,Not statistcially significant,1.073967327,1.1,11,18764,772,19536
41180,"St. Louis, MO-IL",2805190,Metropolitan Statistical Area,Native American,51,40,11,Not enough of applications,5.139433939,5.1,51,18764,772,19536
41180,"St. Louis, MO-IL",2805190,Metropolitan Statistical Area,AAPI,924,865,59,Statistcially significant disparity,1.608967099,1.6,16,18764,772,19536
45860,"Torrington, CT",182002,Micropolitan Statistical Area,Black,25,21,4,Regression equation needs to be tweaked,4.014561969,4,40,894,91,985
45860,"Torrington, CT",182002,Micropolitan Statistical Area,Latino,104,91,13,Regression equation needs to be tweaked,0.762767487,0.8,8,894,91,985
45860,"Torrington, CT",182002,Micropolitan Statistical Area,Native American,2,2,0,Regression equation needs to be tweaked,6.98E-08,0,0,894,91,985
45860,"Torrington, CT",182002,Micropolitan Statistical Area,AAPI,21,18,3,Regression equation needs to be tweaked,2.505901513,2.5,25,894,91,985
11540,"Appleton, WI",235628,Metropolitan Statistical Area,Black,19,15,4,No meaningful results,,,,2298,65,2363
11540,"Appleton, WI",235628,Metropolitan Statistical Area,Latino,59,55,4,No meaningful results,,,,2298,65,2363
11540,"Appleton, WI",235628,Metropolitan Statistical Area,Native American,10,9,1,No meaningful results,,,,2298,65,2363
11540,"Appleton, WI",235628,Metropolitan Statistical Area,AAPI,73,66,7,No meaningful results,,,,2298,65,2363
36780,"Oshkosh-Neenah, WI",170411,Metropolitan Statistical Area,Black,13,11,2,No meaningful results,,,,1406,52,1458
36780,"Oshkosh-Neenah, WI",170411,Metropolitan Statistical Area,Latino,32,30,2,No meaningful results,,,,1406,52,1458
36780,"Oshkosh-Neenah, WI",170411,Metropolitan Statistical Area,Native American,5,5,0,No meaningful results,,,,1406,52,1458
36780,"Oshkosh-Neenah, WI",170411,Metropolitan Statistical Area,AAPI,47,45,2,No meaningful results,,,,1406,52,1458
33340,"Milwaukee-Waukesha, WI",1575223,Metropolitan Statistical Area,Black,574,496,78,Regression equation needs to be tweaked,1.594034357,1.6,16,11288,470,11758
33340,"Milwaukee-Waukesha, WI",1575223,Metropolitan Statistical Area,Latino,990,908,82,Regression equation needs to be tweaked,1.337455407,1.3,13,11288,470,11758
33340,"Milwaukee-Waukesha, WI",1575223,Metropolitan Statistical Area,Native American,36,36,0,Regression equation needs to be tweaked,5.12E-07,0,0,11288,470,11758
33340,"Milwaukee-Waukesha, WI",1575223,Metropolitan Statistical Area,AAPI,795,732,63,Regression equation needs to be tweaked,1.514943242,1.5,15,11288,470,11758
24580,"Green Bay, WI",319401,Metropolitan Statistical Area,Black,16,11,5,No meaningful results,,,,2514,79,2593
24580,"Green Bay, WI",319401,Metropolitan Statistical Area,Latino,150,142,8,No meaningful results,,,,2514,79,2593
24580,"Green Bay, WI",319401,Metropolitan Statistical Area,Native American,11,11,0,No meaningful results,,,,2514,79,2593
24580,"Green Bay, WI",319401,Metropolitan Statistical Area,AAPI,70,61,9,No meaningful results,,,,2514,79,2593
34900,"Napa, CA",139623,Metropolitan Statistical Area,Black,9,7,2,No meaningful results,,,,450,37,487
34900,"Napa, CA",139623,Metropolitan Statistical Area,Latino,101,91,10,No meaningful results,,,,450,37,487
34900,"Napa, CA",139623,Metropolitan Statistical Area,Native American,1,1,0,No meaningful results,,,,450,37,487
34900,"Napa, CA",139623,Metropolitan Statistical Area,AAPI,52,46,6,No meaningful results,,,,450,37,487
33740,"Monroe, LA",203457,Metropolitan Statistical Area,Black,59,48,11,No meaningful results,,,,487,20,507
33740,"Monroe, LA",203457,Metropolitan Statistical Area,Latino,9,9,0,No meaningful results,,,,487,20,507
33740,"Monroe, LA",203457,Metropolitan Statistical Area,Native American,2,2,0,No meaningful results,,,,487,20,507
33740,"Monroe, LA",203457,Metropolitan Statistical Area,AAPI,10,9,1,No meaningful results,,,,487,20,507
16140,"Carroll, IA",20281,Micropolitan Statistical Area,Black,0,0,0,No meaningful results,,,,111,5,116
16140,"Carroll, IA",20281,Micropolitan Statistical Area,Latino,5,5,0,No meaningful results,,,,111,5,116
16140,"Carroll, IA",20281,Micropolitan Statistical Area,Native American,0,0,0,No meaningful results,,,,111,5,116
16140,"Carroll, IA",20281,Micropolitan Statistical Area,AAPI,1,1,0,No meaningful results,,,,111,5,116
47940,"Waterloo-Cedar Falls, IA",169556,Metropolitan Statistical Area,Black,42,41,1,Regression equation needs to be tweaked,0.832020929,0.8,8,1534,44,1578
47940,"Waterloo-Cedar Falls, IA",169556,Metropolitan Statistical Area,Latino,51,50,1,Regression equation needs to be tweaked,0.623436184,0.6,6,1534,44,1578
47940,"Waterloo-Cedar Falls, IA",169556,Metropolitan Statistical Area,Native American,5,5,0,Regression equation needs to be tweaked,8.05E-12,0,0,1534,44,1578
47940,"Waterloo-Cedar Falls, IA",169556,Metropolitan Statistical Area,AAPI,56,56,0,Regression equation needs to be tweaked,7.28E-06,0,0,1534,44,1578
16300,"Cedar Rapids, IA",270056,Metropolitan Statistical Area,Black,70,68,2,No meaningful results,,,,2808,66,2874
16300,"Cedar Rapids, IA",270056,Metropolitan Statistical Area,Latino,67,65,2,No meaningful results,,,,2808,66,2874
16300,"Cedar Rapids, IA",270056,Metropolitan Statistical Area,Native American,2,2,0,No meaningful results,,,,2808,66,2874
16300,"Cedar Rapids, IA",270056,Metropolitan Statistical Area,AAPI,78,75,3,No meaningful results,,,,2808,66,2874
38420,"Platteville, WI",51733,Micropolitan Statistical Area,Black,2,2,0,No meaningful results,,,,238,16,254
38420,"Platteville, WI",51733,Micropolitan Statistical Area,Latino,1,1,0,No meaningful results,,,,238,16,254
38420,"Platteville, WI",51733,Micropolitan Statistical Area,Native American,1,0,1,No meaningful results,,,,238,16,254
38420,"Platteville, WI",51733,Micropolitan Statistical Area,AAPI,1,1,0,No meaningful results,,,,238,16,254
31540,"Madison, WI",653725,Metropolitan Statistical Area,Black,113,104,9,No meaningful results,,,,5634,199,5833
31540,"Madison, WI",653725,Metropolitan Statistical Area,Latino,214,192,22,No meaningful results,,,,5634,199,5833
31540,"Madison, WI",653725,Metropolitan Statistical Area,Native American,16,15,1,No meaningful results,,,,5634,199,5833
31540,"Madison, WI",653725,Metropolitan Statistical Area,AAPI,371,354,17,No meaningful results,,,,5634,199,5833
34700,"Muscatine, IA",42889,Micropolitan Statistical Area,Black,2,2,0,No meaningful results,,,,197,14,211
34700,"Muscatine, IA",42889,Micropolitan Statistical Area,Latino,28,17,11,No meaningful results,,,,197,14,211
34700,"Muscatine, IA",42889,Micropolitan Statistical Area,Native American,0,0,0,No meaningful results,,,,197,14,211
34700,"Muscatine, IA",42889,Micropolitan Statistical Area,AAPI,2,2,0,No meaningful results,,,,197,14,211
19780,"Des Moines-West Des Moines, IA",680439,Metropolitan Statistical Area,Black,140,127,13,Regression equation needs to be tweaked,2.64138199,2.6,26,6871,253,7124
19780,"Des Moines-West Des Moines, IA",680439,Metropolitan Statistical Area,Latino,336,308,28,Regression equation needs to be tweaked,1.142211002,1.1,11,6871,253,7124
19780,"Des Moines-West Des Moines, IA",680439,Metropolitan Statistical Area,Native American,21,19,2,Regression equation needs to be tweaked,1.902414431,1.9,19,6871,253,7124
19780,"Des Moines-West Des Moines, IA",680439,Metropolitan Statistical Area,AAPI,374,348,26,Regression equation needs to be tweaked,1.52980126,1.5,15,6871,253,7124
26980,"Iowa City, IA",170677,Metropolitan Statistical Area,Black,69,65,4,No meaningful results,,,,1721,31,1752
26980,"Iowa City, IA",170677,Metropolitan Statistical Area,Latino,70,69,1,No meaningful results,,,,1721,31,1752
26980,"Iowa City, IA",170677,Metropolitan Statistical Area,Native American,2,2,0,No meaningful results,,,,1721,31,1752
26980,"Iowa City, IA",170677,Metropolitan Statistical Area,AAPI,103,98,5,No meaningful results,,,,1721,31,1752
29100,"La Crosse-Onalaska, WI-MN",136542,Metropolitan Statistical Area,Black,8,8,0,No meaningful results,,,,1093,24,1117
29100,"La Crosse-Onalaska, WI-MN",136542,Metropolitan Statistical Area,Latino,17,17,0,No meaningful results,,,,1093,24,1117
29100,"La Crosse-Onalaska, WI-MN",136542,Metropolitan Statistical Area,Native American,7,7,0,No meaningful results,,,,1093,24,1117
29100,"La Crosse-Onalaska, WI-MN",136542,Metropolitan Statistical Area,AAPI,38,35,3,No meaningful results,,,,1093,24,1117
13180,"Beaver Dam, WI",87715,Micropolitan Statistical Area,Black,3,2,1,No meaningful results,,,,523,35,558
13180,"Beaver Dam, WI",87715,Micropolitan Statistical Area,Latino,22,18,4,No meaningful results,,,,523,35,558
13180,"Beaver Dam, WI",87715,Micropolitan Statistical Area,Native American,4,4,0,No meaningful results,,,,523,35,558
13180,"Beaver Dam, WI",87715,Micropolitan Statistical Area,AAPI,5,4,1,No meaningful results,,,,523,35,558
43100,"Sheboygan, WI",115178,Metropolitan Statistical Area,Black,5,5,0,No meaningful results,,,,809,36,845
43100,"Sheboygan, WI",115178,Metropolitan Statistical Area,Latino,35,33,2,No meaningful results,,,,809,36,845
43100,"Sheboygan, WI",115178,Metropolitan Statistical Area,Native American,2,2,0,No meaningful results,,,,809,36,845
43100,"Sheboygan, WI",115178,Metropolitan Statistical Area,AAPI,63,60,3,No meaningful results,,,,809,36,845
12660,"Baraboo, WI",63922,Micropolitan Statistical Area,Black,4,4,0,No meaningful results,,,,358,31,389
12660,"Baraboo, WI",63922,Micropolitan Statistical Area,Latino,11,9,2,No meaningful results,,,,358,31,389
12660,"Baraboo, WI",63922,Micropolitan Statistical Area,Native American,5,4,1,No meaningful results,,,,358,31,389
12660,"Baraboo, WI",63922,Micropolitan Statistical Area,AAPI,0,0,0,No meaningful results,,,,358,31,389
22540,"Fond du Lac, WI",102597,Metropolitan Statistical Area,Black,6,5,1,Regression equation needs to be tweaked,3.708329158,3.7,37,729,29,758
22540,"Fond du Lac, WI",102597,Metropolitan Statistical Area,Latino,26,26,0,Regression equation needs to be tweaked,5.10E-09,0,0,729,29,758
22540,"Fond du Lac, WI",102597,Metropolitan Statistical Area,Native American,2,2,0,Regression equation needs to be tweaked,8.30E-07,0,0,729,29,758
22540,"Fond du Lac, WI",102597,Metropolitan Statistical Area,AAPI,12,11,1,Regression equation needs to be tweaked,6.406121598,6.4,64,729,29,758
19340,"Davenport-Moline-Rock Island, IA-IL",381175,Metropolitan Statistical Area,Black,73,68,5,Regression equation needs to be tweaked,2.50372565,2.5,25,2403,67,2470
19340,"Davenport-Moline-Rock Island, IA-IL",381175,Metropolitan Statistical Area,Latino,172,156,16,Regression equation needs to be tweaked,3.071055451,3.1,31,2403,67,2470
19340,"Davenport-Moline-Rock Island, IA-IL",381175,Metropolitan Statistical Area,Native American,9,8,1,Regression equation needs to be tweaked,2.721513902,2.7,27,2403,67,2470
19340,"Davenport-Moline-Rock Island, IA-IL",381175,Metropolitan Statistical Area,AAPI,89,86,3,Regression equation needs to be tweaked,1.251476119,1.3,13,2403,67,2470
32380,"Mason City, IA",50279,Micropolitan Statistical Area,Black,1,0,1,No meaningful results,,,,176,12,188
32380,"Mason City, IA",50279,Micropolitan Statistical Area,Latino,6,4,2,No meaningful results,,,,176,12,188
32380,"Mason City, IA",50279,Micropolitan Statistical Area,Native American,1,1,0,No meaningful results,,,,176,12,188
32380,"Mason City, IA",50279,Micropolitan Statistical Area,AAPI,6,6,0,No meaningful results,,,,176,12,188
17540,"Clinton, IA",46909,Micropolitan Statistical Area,Black,2,2,0,No meaningful results,,,,210,9,219
17540,"Clinton, IA",46909,Micropolitan Statistical Area,Latino,4,4,0,No meaningful results,,,,210,9,219
17540,"Clinton, IA",46909,Micropolitan Statistical Area,Native American,1,1,0,No meaningful results,,,,210,9,219
17540,"Clinton, IA",46909,Micropolitan Statistical Area,AAPI,1,1,0,No meaningful results,,,,210,9,219
39500,"Quincy, IL-MO",76040,Micropolitan Statistical Area,Black,5,5,0,No meaningful results,,,,279,11,290
39500,"Quincy, IL-MO",76040,Micropolitan Statistical Area,Latino,7,7,0,No meaningful results,,,,279,11,290
39500,"Quincy, IL-MO",76040,Micropolitan Statistical Area,Native American,0,0,0,No meaningful results,,,,279,11,290
39500,"Quincy, IL-MO",76040,Micropolitan Statistical Area,AAPI,5,5,0,No meaningful results,,,,279,11,290
42860,"Seneca, SC",77528,Micropolitan Statistical Area,Black,8,6,2,No meaningful results,,,,412,41,453
42860,"Seneca, SC",77528,Micropolitan Statistical Area,Latino,8,7,1,No meaningful results,,,,412,41,453
42860,"Seneca, SC",77528,Micropolitan Statistical Area,Native American,0,0,0,No meaningful results,,,,412,41,453
42860,"Seneca, SC",77528,Micropolitan Statistical Area,AAPI,2,2,0,No meaningful results,,,,412,41,453
27500,"Janesville-Beloit, WI",162152,Metropolitan Statistical Area,Black,24,18,6,No meaningful results,,,,1206,57,1263
27500,"Janesville-Beloit, WI",162152,Metropolitan Statistical Area,Latino,63,54,9,No meaningful results,,,,1206,57,1263
27500,"Janesville-Beloit, WI",162152,Metropolitan Statistical Area,Native American,8,7,1,No meaningful results,,,,1206,57,1263
27500,"Janesville-Beloit, WI",162152,Metropolitan Statistical Area,AAPI,8,7,1,No meaningful results,,,,1206,57,1263
11180,"Ames, IA",123311,Metropolitan Statistical Area,Black,7,4,3,No meaningful results,,,,824,31,855
11180,"Ames, IA",123311,Metropolitan Statistical Area,Latino,17,16,1,No meaningful results,,,,824,31,855
11180,"Ames, IA",123311,Metropolitan Statistical Area,Native American,4,4,0,No meaningful results,,,,824,31,855
11180,"Ames, IA",123311,Metropolitan Statistical Area,AAPI,33,32,1,No meaningful results,,,,824,31,855
32820,"Memphis, TN-MS-AR",1339623,Metropolitan Statistical Area,Black,1033,915,118,Regression equation needs to be tweaked,2.060197806,2.1,21,4876,198,5074
32820,"Memphis, TN-MS-AR",1339623,Metropolitan Statistical Area,Latino,280,257,23,Regression equation needs to be tweaked,1.523113828,1.5,15,4876,198,5074
32820,"Memphis, TN-MS-AR",1339623,Metropolitan Statistical Area,Native American,16,16,0,Regression equation needs to be tweaked,1.48E-08,0,0,4876,198,5074
32820,"Memphis, TN-MS-AR",1339623,Metropolitan Statistical Area,AAPI,344,325,19,Regression equation needs to be tweaked,1.258499396,1.3,13,4876,198,5074
19180,"Danville, IL",77563,Metropolitan Statistical Area,Black,7,7,0,No meaningful results,,,,121,14,135
19180,"Danville, IL",77563,Metropolitan Statistical Area,Latino,5,4,1,No meaningful results,,,,121,14,135
19180,"Danville, IL",77563,Metropolitan Statistical Area,Native American,1,1,0,No meaningful results,,,,121,14,135
19180,"Danville, IL",77563,Metropolitan Statistical Area,AAPI,0,0,0,No meaningful results,,,,121,14,135
22700,"Fort Dodge, IA",36545,Micropolitan Statistical Area,Black,2,2,0,No meaningful results,,,,240,19,259
22700,"Fort Dodge, IA",36545,Micropolitan Statistical Area,Latino,9,8,1,No meaningful results,,,,240,19,259
22700,"Fort Dodge, IA",36545,Micropolitan Statistical Area,Native American,1,1,0,No meaningful results,,,,240,19,259
22700,"Fort Dodge, IA",36545,Micropolitan Statistical Area,AAPI,1,1,0,No meaningful results,,,,240,19,259
15460,"Burlington, IA-IL",46195,Micropolitan Statistical Area,Black,3,3,0,No meaningful results,,,,166,21,187
15460,"Burlington, IA-IL",46195,Micropolitan Statistical Area,Latino,5,4,1,No meaningful results,,,,166,21,187
15460,"Burlington, IA-IL",46195,Micropolitan Statistical Area,Native American,0,0,0,No meaningful results,,,,166,21,187
15460,"Burlington, IA-IL",46195,Micropolitan Statistical Area,AAPI,3,3,0,No meaningful results,,,,166,21,187
24380,"Grants, NM",26891,Micropolitan Statistical Area,Black,1,1,0,No meaningful results,,,,14,0,14
24380,"Grants, NM",26891,Micropolitan Statistical Area,Latino,6,6,0,No meaningful results,,,,14,0,14
24380,"Grants, NM",26891,Micropolitan Statistical Area,Native American,0,0,0,No meaningful results,,,,14,0,14
24380,"Grants, NM",26891,Micropolitan Statistical Area,AAPI,0,0,0,No meaningful results,,,,14,0,14
23300,"Freeport, IL",45093,Micropolitan Statistical Area,Black,3,3,0,No meaningful results,,,,106,15,121
23300,"Freeport, IL",45093,Micropolitan Statistical Area,Latino,9,7,2,No meaningful results,,,,106,15,121
23300,"Freeport, IL",45093,Micropolitan Statistical Area,Native American,0,0,0,No meaningful results,,,,106,15,121
23300,"Freeport, IL",45093,Micropolitan Statistical Area,AAPI,0,0,0,No meaningful results,,,,106,15,121
18140,"Columbus, OH",2077761,Metropolitan Statistical Area,Black,1226,1099,127,Statistcially significant disparity,2.126616258,2.1,21,14829,625,15454
18140,"Columbus, OH",2077761,Metropolitan Statistical Area,Latino,495,445,50,Statistcially significant disparity,2.102538978,2.1,21,14829,625,15454
18140,"Columbus, OH",2077761,Metropolitan Statistical Area,Native American,42,37,5,Not statistcially significant,2.80172286,2.8,28,14829,625,15454
18140,"Columbus, OH",2077761,Metropolitan Statistical Area,AAPI,1603,1504,99,Statistcially significant disparity,1.58470292,1.6,16,14829,625,15454
17460,"Cleveland-Elyria, OH",2056898,Metropolitan Statistical Area,Black,770,658,112,Statistcially significant disparity,1.704264572,1.7,17,12981,577,13558
17460,"Cleveland-Elyria, OH",2056898,Metropolitan Statistical Area,Latino,536,500,36,Not statistcially significant,1.110982639,1.1,11,12981,577,13558
17460,"Cleveland-Elyria, OH",2056898,Metropolitan Statistical Area,Native American,31,26,5,Not statistcially significant,1.105559283,1.1,11,12981,577,13558
17460,"Cleveland-Elyria, OH",2056898,Metropolitan Statistical Area,AAPI,498,456,42,Statistcially significant disparity,1.841919272,1.8,18,12981,577,13558
19430,"Dayton-Kettering, OH",803543,Metropolitan Statistical Area,Black,278,248,30,Statistcially significant disparity,2.858027853,2.9,29,4784,137,4921
19430,"Dayton-Kettering, OH",803543,Metropolitan Statistical Area,Latino,137,129,8,Not statistcially significant,1.687766101,1.7,17,4784,137,4921
19430,"Dayton-Kettering, OH",803543,Metropolitan Statistical Area,Native American,11,9,2,Not enough of applications,9.751180252,9.8,98,4784,137,4921
19430,"Dayton-Kettering, OH",803543,Metropolitan Statistical Area,AAPI,234,221,13,Statistcially significant disparity,2.059146177,2.1,21,4784,137,4921
44220,"Springfield, OH",134726,Metropolitan Statistical Area,Black,21,17,4,No meaningful results,,,,533,24,557
44220,"Springfield, OH",134726,Metropolitan Statistical Area,Latino,12,8,4,No meaningful results,,,,533,24,557
44220,"Springfield, OH",134726,Metropolitan Statistical Area,Native American,2,1,1,No meaningful results,,,,533,24,557
44220,"Springfield, OH",134726,Metropolitan Statistical Area,AAPI,8,8,0,No meaningful results,,,,533,24,557
48540,"Wheeling, WV-OH",141475,Metropolitan Statistical Area,Black,4,3,1,No meaningful results,,,,480,53,533
48540,"Wheeling, WV-OH",141475,Metropolitan Statistical Area,Latino,5,3,2,No meaningful results,,,,480,53,533
48540,"Wheeling, WV-OH",141475,Metropolitan Statistical Area,Native American,0,0,0,No meaningful results,,,,480,53,533
48540,"Wheeling, WV-OH",141475,Metropolitan Statistical Area,AAPI,6,4,2,No meaningful results,,,,480,53,533
17300,"Clarksville, TN-KY",299470,Metropolitan Statistical Area,Black,95,78,17,Regression equation needs to be tweaked,3.380646078,3.4,34,839,54,893
17300,"Clarksville, TN-KY",299470,Metropolitan Statistical Area,Latino,62,54,8,Regression equation needs to be tweaked,1.43940283,1.4,14,839,54,893
17300,"Clarksville, TN-KY",299470,Metropolitan Statistical Area,Native American,7,5,2,Regression equation needs to be tweaked,1.083883287,1.1,11,839,54,893
17300,"Clarksville, TN-KY",299470,Metropolitan Statistical Area,AAPI,40,37,3,Regression equation needs to be tweaked,1.272205494,1.3,13,839,54,893
46500,"Urbana, OH",38845,Micropolitan Statistical Area,Black,5,5,0,No meaningful results,,,,147,16,163
46500,"Urbana, OH",38845,Micropolitan Statistical Area,Latino,1,1,0,No meaningful results,,,,147,16,163
46500,"Urbana, OH",38845,Micropolitan Statistical Area,Native American,2,2,0,No meaningful results,,,,147,16,163
46500,"Urbana, OH",38845,Micropolitan Statistical Area,AAPI,0,0,0,No meaningful results,,,,147,16,163
47920,"Washington Court House, OH",28620,Micropolitan Statistical Area,Black,0,0,0,No meaningful results,,,,126,8,134
47920,"Washington Court House, OH",28620,Micropolitan Statistical Area,Latino,1,1,0,No meaningful results,,,,126,8,134
47920,"Washington Court House, OH",28620,Micropolitan Statistical Area,Native American,2,1,1,No meaningful results,,,,126,8,134
47920,"Washington Court House, OH",28620,Micropolitan Statistical Area,AAPI,3,3,0,No meaningful results,,,,126,8,134
34540,"Mount Vernon, OH",61481,Micropolitan Statistical Area,Black,2,2,0,No meaningful results,,,,391,20,411
34540,"Mount Vernon, OH",61481,Micropolitan Statistical Area,Latino,7,7,0,No meaningful results,,,,391,20,411
34540,"Mount Vernon, OH",61481,Micropolitan Statistical Area,Native American,0,0,0,No meaningful results,,,,391,20,411
34540,"Mount Vernon, OH",61481,Micropolitan Statistical Area,AAPI,4,4,0,No meaningful results,,,,391,20,411
45660,"Tiffin, OH",55351,Micropolitan Statistical Area,Black,2,2,0,No meaningful results,,,,167,17,184
45660,"Tiffin, OH",55351,Micropolitan Statistical Area,Latino,5,3,2,No meaningful results,,,,167,17,184
45660,"Tiffin, OH",55351,Micropolitan Statistical Area,Native American,0,0,0,No meaningful results,,,,167,17,184
45660,"Tiffin, OH",55351,Micropolitan Statistical Area,AAPI,2,2,0,No meaningful results,,,,167,17,184
13340,"Bellefontaine, OH",45316,Micropolitan Statistical Area,Black,1,1,0,No meaningful results,,,,184,9,193
13340,"Bellefontaine, OH",45316,Micropolitan Statistical Area,Latino,5,5,0,No meaningful results,,,,184,9,193
13340,"Bellefontaine, OH",45316,Micropolitan Statistical Area,Native American,0,0,0,No meaningful results,,,,184,9,193
13340,"Bellefontaine, OH",45316,Micropolitan Statistical Area,AAPI,2,2,0,No meaningful results,,,,184,9,193
32020,"Marion, OH",65299,Micropolitan Statistical Area,Black,7,4,3,No meaningful results,,,,302,15,317
32020,"Marion, OH",65299,Micropolitan Statistical Area,Latino,5,5,0,No meaningful results,,,,302,15,317
32020,"Marion, OH",65299,Micropolitan Statistical Area,Native American,0,0,0,No meaningful results,,,,302,15,317
32020,"Marion, OH",65299,Micropolitan Statistical Area,AAPI,3,3,0,No meaningful results,,,,302,15,317
11740,"Ashland, OH",53536,Micropolitan Statistical Area,Black,0,0,0,No meaningful results,,,,302,13,315
11740,"Ashland, OH",53536,Micropolitan Statistical Area,Latino,2,1,1,No meaningful results,,,,302,13,315
11740,"Ashland, OH",53536,Micropolitan Statistical Area,Native American,1,1,0,No meaningful results,,,,302,13,315
11740,"Ashland, OH",53536,Micropolitan Statistical Area,AAPI,0,0,0,No meaningful results,,,,302,13,315
49300,"Wooster, OH",116099,Micropolitan Statistical Area,Black,5,5,0,No meaningful results,,,,559,23,582
49300,"Wooster, OH",116099,Micropolitan Statistical Area,Latino,6,5,1,No meaningful results,,,,559,23,582
49300,"Wooster, OH",116099,Micropolitan Statistical Area,Native American,0,0,0,No meaningful results,,,,559,23,582
49300,"Wooster, OH",116099,Micropolitan Statistical Area,AAPI,7,7,0,No meaningful results,,,,559,23,582
46100,"Tullahoma-Manchester, TN",103312,Micropolitan Statistical Area,Black,11,10,1,No meaningful results,,,,412,19,431
46100,"Tullahoma-Manchester, TN",103312,Micropolitan Statistical Area,Latino,15,13,2,No meaningful results,,,,412,19,431
46100,"Tullahoma-Manchester, TN",103312,Micropolitan Statistical Area,Native American,2,2,0,No meaningful results,,,,412,19,431
46100,"Tullahoma-Manchester, TN",103312,Micropolitan Statistical Area,AAPI,13,11,2,No meaningful results,,,,412,19,431
15340,"Bucyrus-Galion, OH",41821,Micropolitan Statistical Area,Black,0,0,0,No meaningful results,,,,126,10,136
15340,"Bucyrus-Galion, OH",41821,Micropolitan Statistical Area,Latino,1,1,0,No meaningful results,,,,126,10,136
15340,"Bucyrus-Galion, OH",41821,Micropolitan Statistical Area,Native American,0,0,0,No meaningful results,,,,126,10,136
15340,"Bucyrus-Galion, OH",41821,Micropolitan Statistical Area,AAPI,0,0,0,No meaningful results,,,,126,10,136
31900,"Mansfield, OH",121100,Metropolitan Statistical Area,Black,13,13,0,No meaningful results,,,,702,41,743
31900,"Mansfield, OH",121100,Metropolitan Statistical Area,Latino,4,4,0,No meaningful results,,,,702,41,743
31900,"Mansfield, OH",121100,Metropolitan Statistical Area,Native American,0,0,0,No meaningful results,,,,702,41,743
31900,"Mansfield, OH",121100,Metropolitan Statistical Area,AAPI,8,8,0,No meaningful results,,,,702,41,743
30620,"Lima, OH",103175,Metropolitan Statistical Area,Black,31,29,2,No meaningful results,,,,583,33,616
30620,"Lima, OH",103175,Metropolitan Statistical Area,Latino,13,11,2,No meaningful results,,,,583,33,616
30620,"Lima, OH",103175,Metropolitan Statistical Area,Native American,1,1,0,No meaningful results,,,,583,33,616
30620,"Lima, OH",103175,Metropolitan Statistical Area,AAPI,12,12,0,No meaningful results,,,,583,33,616
11780,"Ashtabula, OH",97830,Micropolitan Statistical Area,Black,1,1,0,No meaningful results,,,,236,25,261
11780,"Ashtabula, OH",97830,Micropolitan Statistical Area,Latino,4,4,0,No meaningful results,,,,236,25,261
11780,"Ashtabula, OH",97830,Micropolitan Statistical Area,Native American,2,2,0,No meaningful results,,,,236,25,261
11780,"Ashtabula, OH",97830,Micropolitan Statistical Area,AAPI,1,1,0,No meaningful results,,,,236,25,261
17060,"Chillicothe, OH",76948,Micropolitan Statistical Area,Black,3,3,0,No meaningful results,,,,298,20,318
17060,"Chillicothe, OH",76948,Micropolitan Statistical Area,Latino,3,3,0,No meaningful results,,,,298,20,318
17060,"Chillicothe, OH",76948,Micropolitan Statistical Area,Native American,1,1,0,No meaningful results,,,,298,20,318
17060,"Chillicothe, OH",76948,Micropolitan Statistical Area,AAPI,1,1,0,No meaningful results,,,,298,20,318
11900,"Athens, OH",65917,Micropolitan Statistical Area,Black,6,6,0,No meaningful results,,,,121,8,129
11900,"Athens, OH",65917,Micropolitan Statistical Area,Latino,0,0,0,No meaningful results,,,,121,8,129
11900,"Athens, OH",65917,Micropolitan Statistical Area,Native American,1,1,0,No meaningful results,,,,121,8,129
11900,"Athens, OH",65917,Micropolitan Statistical Area,AAPI,2,2,0,No meaningful results,,,,121,8,129
48260,"Weirton-Steubenville, WV-OH",118213,Metropolitan Statistical Area,Black,2,2,0,No meaningful results,,,,417,25,442
48260,"Weirton-Steubenville, WV-OH",118213,Metropolitan Statistical Area,Latino,1,1,0,No meaningful results,,,,417,25,442
48260,"Weirton-Steubenville, WV-OH",118213,Metropolitan Statistical Area,Native American,0,0,0,No meaningful results,,,,417,25,442
48260,"Weirton-Steubenville, WV-OH",118213,Metropolitan Statistical Area,AAPI,1,1,0,No meaningful results,,,,417,25,442
48940,"Wilmington, OH",41957,Micropolitan Statistical Area,Black,1,1,0,No meaningful results,,,,174,12,186
48940,"Wilmington, OH",41957,Micropolitan Statistical Area,Latino,3,3,0,No meaningful results,,,,174,12,186
48940,"Wilmington, OH",41957,Micropolitan Statistical Area,Native American,0,0,0,No meaningful results,,,,174,12,186
48940,"Wilmington, OH",41957,Micropolitan Statistical Area,AAPI,2,1,1,No meaningful results,,,,174,12,186
47664,"Warren-Troy-Farmington Hills, MI",2560549,Metropolitan Division,Black,1047,926,121,Statistcially significant disparity,2.081439825,2.1,21,19815,920,20735
47664,"Warren-Troy-Farmington Hills, MI",2560549,Metropolitan Division,Latino,663,620,43,Not statistcially significant,1.362523836,1.4,14,19815,920,20735
47664,"Warren-Troy-Farmington Hills, MI",2560549,Metropolitan Division,Native American,53,51,2,Not statistcially significant,0.491668936,0.5,5,19815,920,20735
47664,"Warren-Troy-Farmington Hills, MI",2560549,Metropolitan Division,AAPI,1715,1623,92,Not statistcially significant,1.037699864,1,10,19815,920,20735
43020,"Shawano, WI",45462,Micropolitan Statistical Area,Black,0,0,0,No meaningful results,,,,163,8,171
43020,"Shawano, WI",45462,Micropolitan Statistical Area,Latino,2,2,0,No meaningful results,,,,163,8,171
43020,"Shawano, WI",45462,Micropolitan Statistical Area,Native American,5,4,1,No meaningful results,,,,163,8,171
43020,"Shawano, WI",45462,Micropolitan Statistical Area,AAPI,1,1,0,No meaningful results,,,,163,8,171
31940,"Marinette, WI-MI",63465,Micropolitan Statistical Area,Black,2,2,0,No meaningful results,,,,198,18,216
31940,"Marinette, WI-MI",63465,Micropolitan Statistical Area,Latino,3,3,0,No meaningful results,,,,198,18,216
31940,"Marinette, WI-MI",63465,Micropolitan Statistical Area,Native American,0,0,0,No meaningful results,,,,198,18,216
31940,"Marinette, WI-MI",63465,Micropolitan Statistical Area,AAPI,0,0,0,No meaningful results,,,,198,18,216
20740,"Eau Claire, WI",167406,Metropolitan Statistical Area,Black,5,5,0,No meaningful results,,,,1420,71,1491
20740,"Eau Claire, WI",167406,Metropolitan Statistical Area,Latino,28,26,2,No meaningful results,,,,1420,71,1491
20740,"Eau Claire, WI",167406,Metropolitan Statistical Area,Native American,2,2,0,No meaningful results,,,,1420,71,1491
20740,"Eau Claire, WI",167406,Metropolitan Statistical Area,AAPI,50,43,7,No meaningful results,,,,1420,71,1491
27020,"Iron Mountain, MI-WI",29753,Micropolitan Statistical Area,Black,1,1,0,No meaningful results,,,,59,8,67
27020,"Iron Mountain, MI-WI",29753,Micropolitan Statistical Area,Latino,0,0,0,No meaningful results,,,,59,8,67
27020,"Iron Mountain, MI-WI",29753,Micropolitan Statistical Area,Native American,1,0,1,No meaningful results,,,,59,8,67
27020,"Iron Mountain, MI-WI",29753,Micropolitan Statistical Area,AAPI,1,0,1,No meaningful results,,,,59,8,67
44620,"Stevens Point, WI",70632,Micropolitan Statistical Area,Black,1,1,0,No meaningful results,,,,335,18,353
44620,"Stevens Point, WI",70632,Micropolitan Statistical Area,Latino,7,7,0,No meaningful results,,,,335,18,353
44620,"Stevens Point, WI",70632,Micropolitan Statistical Area,Native American,3,3,0,No meaningful results,,,,335,18,353
44620,"Stevens Point, WI",70632,Micropolitan Statistical Area,AAPI,9,8,1,No meaningful results,,,,335,18,353
48140,"Wausau-Weston, WI",163140,Metropolitan Statistical Area,Black,7,4,3,No meaningful results,,,,812,57,869
48140,"Wausau-Weston, WI",163140,Metropolitan Statistical Area,Latino,15,11,4,No meaningful results,,,,812,57,869
48140,"Wausau-Weston, WI",163140,Metropolitan Statistical Area,Native American,6,5,1,No meaningful results,,,,812,57,869
48140,"Wausau-Weston, WI",163140,Metropolitan Statistical Area,AAPI,38,35,3,No meaningful results,,,,812,57,869
14140,"Bluefield, WV-VA",107910,Micropolitan Statistical Area,Black,6,5,1,No meaningful results,,,,231,35,266
14140,"Bluefield, WV-VA",107910,Micropolitan Statistical Area,Latino,1,1,0,No meaningful results,,,,231,35,266
14140,"Bluefield, WV-VA",107910,Micropolitan Statistical Area,Native American,1,1,0,No meaningful results,,,,231,35,266
14140,"Bluefield, WV-VA",107910,Micropolitan Statistical Area,AAPI,8,5,3,No meaningful results,,,,231,35,266
48620,"Wichita, KS",637690,Metropolitan Statistical Area,Black,94,83,11,Statistcially significant disparity,2.290507046,2.3,23,3480,146,3626
48620,"Wichita, KS",637690,Metropolitan Statistical Area,Latino,316,290,26,Not statistcially significant,1.441911998,1.4,14,3480,146,3626
48620,"Wichita, KS",637690,Metropolitan Statistical Area,Native American,31,28,3,Not statistcially significant,1.145128815,1.1,11,3480,146,3626
48620,"Wichita, KS",637690,Metropolitan Statistical Area,AAPI,231,213,18,Statistcially significant disparity,2.042174554,2,20,3480,146,3626
49060,"Winfield, KS",35351,Micropolitan Statistical Area,Black,0,0,0,No meaningful results,,,,99,9,108
49060,"Winfield, KS",35351,Micropolitan Statistical Area,Latino,2,2,0,No meaningful results,,,,99,9,108
49060,"Winfield, KS",35351,Micropolitan Statistical Area,Native American,1,1,0,No meaningful results,,,,99,9,108
49060,"Winfield, KS",35351,Micropolitan Statistical Area,AAPI,1,1,0,No meaningful results,,,,99,9,108
45820,"Topeka, KS",232778,Metropolitan Statistical Area,Black,27,26,1,Not statistcially significant,0.200080716,0.2,2,1016,53,1069
45820,"Topeka, KS",232778,Metropolitan Statistical Area,Latino,76,67,9,Not statistcially significant,0.7970967,0.8,8,1016,53,1069
45820,"Topeka, KS",232778,Metropolitan Statistical Area,Native American,5,4,1,Not statistcially significant,4.571108087,4.6,46,1016,53,1069
45820,"Topeka, KS",232778,Metropolitan Statistical Area,AAPI,12,10,2,Not statistcially significant,0.84428342,0.8,8,1016,53,1069
29940,"Lawrence, KS",120290,Metropolitan Statistical Area,Black,21,21,0,No meaningful results,,,,750,27,777
29940,"Lawrence, KS",120290,Metropolitan Statistical Area,Latino,23,21,2,No meaningful results,,,,750,27,777
29940,"Lawrence, KS",120290,Metropolitan Statistical Area,Native American,12,11,1,No meaningful results,,,,750,27,777
29940,"Lawrence, KS",120290,Metropolitan Statistical Area,AAPI,22,21,1,No meaningful results,,,,750,27,777
31740,"Manhattan, KS",132928,Metropolitan Statistical Area,Black,10,9,1,No meaningful results,,,,467,19,486
31740,"Manhattan, KS",132928,Metropolitan Statistical Area,Latino,22,20,2,No meaningful results,,,,467,19,486
31740,"Manhattan, KS",132928,Metropolitan Statistical Area,Native American,8,8,0,No meaningful results,,,,467,19,486
31740,"Manhattan, KS",132928,Metropolitan Statistical Area,AAPI,24,23,1,No meaningful results,,,,467,19,486
41460,"Salina, KS",60523,Micropolitan Statistical Area,Black,1,1,0,No meaningful results,,,,134,8,142
41460,"Salina, KS",60523,Micropolitan Statistical Area,Latino,10,9,1,No meaningful results,,,,134,8,142
41460,"Salina, KS",60523,Micropolitan Statistical Area,Native American,0,0,0,No meaningful results,,,,134,8,142
41460,"Salina, KS",60523,Micropolitan Statistical Area,AAPI,4,4,0,No meaningful results,,,,134,8,142
36840,"Ottawa, KS",25558,Micropolitan Statistical Area,Black,2,1,1,No meaningful results,,,,110,2,112
36840,"Ottawa, KS",25558,Micropolitan Statistical Area,Latino,3,2,1,No meaningful results,,,,110,2,112
36840,"Ottawa, KS",25558,Micropolitan Statistical Area,Native American,1,1,0,No meaningful results,,,,110,2,112
36840,"Ottawa, KS",25558,Micropolitan Statistical Area,AAPI,0,0,0,No meaningful results,,,,110,2,112
27100,"Jackson, MI",158636,Metropolitan Statistical Area,Black,16,14,2,No meaningful results,,,,843,38,881
27100,"Jackson, MI",158636,Metropolitan Statistical Area,Latino,16,16,0,No meaningful results,,,,843,38,881
27100,"Jackson, MI",158636,Metropolitan Statistical Area,Native American,3,3,0,No meaningful results,,,,843,38,881
27100,"Jackson, MI",158636,Metropolitan Statistical Area,AAPI,12,12,0,No meaningful results,,,,843,38,881
47380,"Waco, TX",268361,Metropolitan Statistical Area,Black,45,40,5,Regression equation needs to be tweaked,1.500949379,1.5,15,1040,42,1082
47380,"Waco, TX",268361,Metropolitan Statistical Area,Latino,181,161,20,Regression equation needs to be tweaked,3.258749562,3.3,33,1040,42,1082
47380,"Waco, TX",268361,Metropolitan Statistical Area,Native American,9,8,1,Regression equation needs to be tweaked,5.41330913,5.4,54,1040,42,1082
47380,"Waco, TX",268361,Metropolitan Statistical Area,AAPI,44,41,3,Regression equation needs to be tweaked,2.417384127,2.4,24,1040,42,1082
25420,"Harrisburg-Carlisle, PA",571013,Metropolitan Statistical Area,Black,137,119,18,Statistcially significant disparity,2.324130492,2.3,23,3069,144,3213
25420,"Harrisburg-Carlisle, PA",571013,Metropolitan Statistical Area,Latino,114,101,13,Not statistcially significant,1.861136597,1.9,19,3069,144,3213
25420,"Harrisburg-Carlisle, PA",571013,Metropolitan Statistical Area,Native American,8,7,1,Not statistcially significant,4.076683299,4.1,41,3069,144,3213
25420,"Harrisburg-Carlisle, PA",571013,Metropolitan Statistical Area,AAPI,489,452,37,Statistcially significant disparity,2.056758055,2.1,21,3069,144,3213
19804,"Detroit-Dearborn-Livonia, MI",1757299,Metropolitan Division,Black,883,722,161,Statistcially significant disparity,2.438151845,2.4,24,6742,357,7099
19804,"Detroit-Dearborn-Livonia, MI",1757299,Metropolitan Division,Latino,353,322,31,Not statistcially significant,1.221042913,1.2,12,6742,357,7099
19804,"Detroit-Dearborn-Livonia, MI",1757299,Metropolitan Division,Native American,24,15,9,Not enough of applications,9.237422712,9.2,92,6742,357,7099
19804,"Detroit-Dearborn-Livonia, MI",1757299,Metropolitan Division,AAPI,656,596,60,Statistcially significant disparity,1.670396899,1.7,17,6742,357,7099
28660,"Killeen-Temple, TX",444716,Metropolitan Statistical Area,Black,89,76,13,Regression equation needs to be tweaked,1.920678378,1.9,19,1119,51,1170
28660,"Killeen-Temple, TX",444716,Metropolitan Statistical Area,Latino,190,170,20,Regression equation needs to be tweaked,1.521858165,1.5,15,1119,51,1170
28660,"Killeen-Temple, TX",444716,Metropolitan Statistical Area,Native American,7,7,0,Regression equation needs to be tweaked,3.84E-07,0,0,1119,51,1170
28660,"Killeen-Temple, TX",444716,Metropolitan Statistical Area,AAPI,77,70,7,Regression equation needs to be tweaked,1.515350884,1.5,15,1119,51,1170
36220,"Odessa, TX",160579,Metropolitan Statistical Area,Black,26,24,2,No meaningful results,,,,374,15,389
36220,"Odessa, TX",160579,Metropolitan Statistical Area,Latino,316,294,22,No meaningful results,,,,374,15,389
36220,"Odessa, TX",160579,Metropolitan Statistical Area,Native American,2,1,1,No meaningful results,,,,374,15,389
36220,"Odessa, TX",160579,Metropolitan Statistical Area,AAPI,27,22,5,No meaningful results,,,,374,15,389
14100,"Bloomsburg-Berwick, PA",83974,Metropolitan Statistical Area,Black,3,3,0,No meaningful results,,,,324,21,345
14100,"Bloomsburg-Berwick, PA",83974,Metropolitan Statistical Area,Latino,6,6,0,No meaningful results,,,,324,21,345
14100,"Bloomsburg-Berwick, PA",83974,Metropolitan Statistical Area,Native American,1,1,0,No meaningful results,,,,324,21,345
14100,"Bloomsburg-Berwick, PA",83974,Metropolitan Statistical Area,AAPI,15,13,2,No meaningful results,,,,324,21,345
11820,"Astoria, OR",39102,Micropolitan Statistical Area,Black,1,1,0,No meaningful results,,,,256,19,275
11820,"Astoria, OR",39102,Micropolitan Statistical Area,Latino,12,11,1,No meaningful results,,,,256,19,275
11820,"Astoria, OR",39102,Micropolitan Statistical Area,Native American,1,1,0,No meaningful results,,,,256,19,275
11820,"Astoria, OR",39102,Micropolitan Statistical Area,AAPI,7,7,0,No meaningful results,,,,256,19,275
43780,"South Bend-Mishawaka, IN-MI",321739,Metropolitan Statistical Area,Black,113,102,11,No meaningful results,,,,2123,92,2215
43780,"South Bend-Mishawaka, IN-MI",321739,Metropolitan Statistical Area,Latino,164,148,16,No meaningful results,,,,2123,92,2215
43780,"South Bend-Mishawaka, IN-MI",321739,Metropolitan Statistical Area,Native American,7,7,0,No meaningful results,,,,2123,92,2215
43780,"South Bend-Mishawaka, IN-MI",321739,Metropolitan Statistical Area,AAPI,86,79,7,No meaningful results,,,,2123,92,2215
35380,"New Orleans-Metairie, LA",1267777,Metropolitan Statistical Area,Black,773,672,101,Regression equation needs to be tweaked,1.955661051,2,20,4773,225,4998
35380,"New Orleans-Metairie, LA",1267777,Metropolitan Statistical Area,Latino,378,348,30,Regression equation needs to be tweaked,1.204435545,1.2,12,4773,225,4998
35380,"New Orleans-Metairie, LA",1267777,Metropolitan Statistical Area,Native American,19,19,0,Regression equation needs to be tweaked,4.66E-09,0,0,4773,225,4998
35380,"New Orleans-Metairie, LA",1267777,Metropolitan Statistical Area,AAPI,337,318,19,Regression equation needs to be tweaked,1.217583376,1.2,12,4773,225,4998
22500,"Florence, SC",205502,Metropolitan Statistical Area,Black,108,85,23,Statistcially significant disparity,2.549268139,2.5,25,599,35,634
22500,"Florence, SC",205502,Metropolitan Statistical Area,Latino,25,22,3,Not statistcially significant,2.839178949,2.8,28,599,35,634
22500,"Florence, SC",205502,Metropolitan Statistical Area,Native American,5,4,1,Not statistcially significant,8.399577064,8.4,84,599,35,634
22500,"Florence, SC",205502,Metropolitan Statistical Area,AAPI,39,35,4,Not statistcially significant,1.489237138,1.5,15,599,35,634
25180,"Hagerstown-Martinsburg, MD-WV",283147,Metropolitan Statistical Area,Black,93,84,9,No meaningful results,,,,1213,68,1281
25180,"Hagerstown-Martinsburg, MD-WV",283147,Metropolitan Statistical Area,Latino,96,83,13,No meaningful results,,,,1213,68,1281
25180,"Hagerstown-Martinsburg, MD-WV",283147,Metropolitan Statistical Area,Native American,9,8,1,No meaningful results,,,,1213,68,1281
25180,"Hagerstown-Martinsburg, MD-WV",283147,Metropolitan Statistical Area,AAPI,37,35,2,No meaningful results,,,,1213,68,1281
29540,"Lancaster, PA",540999,Metropolitan Statistical Area,Black,86,72,14,Regression equation needs to be tweaked,3.607064647,3.6,36,3138,124,3262
29540,"Lancaster, PA",540999,Metropolitan Statistical Area,Latino,177,166,11,Regression equation needs to be tweaked,1.475835031,1.5,15,3138,124,3262
29540,"Lancaster, PA",540999,Metropolitan Statistical Area,Native American,3,3,0,Regression equation needs to be tweaked,4.89E-09,0,0,3138,124,3262
29540,"Lancaster, PA",540999,Metropolitan Statistical Area,AAPI,160,145,15,Regression equation needs to be tweaked,2.091147366,2.1,21,3138,124,3262
36540,"Omaha-Council Bluffs, NE-IA",931779,Metropolitan Statistical Area,Black,161,151,10,Regression equation needs to be tweaked,2.451094317,2.5,25,6490,172,6662
36540,"Omaha-Council Bluffs, NE-IA",931779,Metropolitan Statistical Area,Latino,425,402,23,Regression equation needs to be tweaked,1.285080517,1.3,13,6490,172,6662
36540,"Omaha-Council Bluffs, NE-IA",931779,Metropolitan Statistical Area,Native American,23,22,1,Regression equation needs to be tweaked,1.932926506,1.9,19,6490,172,6662
36540,"Omaha-Council Bluffs, NE-IA",931779,Metropolitan Statistical Area,AAPI,408,391,17,Regression equation needs to be tweaked,1.865561218,1.9,19,6490,172,6662
42700,"Sebring-Avon Park, FL",103437,Metropolitan Statistical Area,Black,13,7,6,No meaningful results,,,,291,36,327
42700,"Sebring-Avon Park, FL",103437,Metropolitan Statistical Area,Latino,94,76,18,No meaningful results,,,,291,36,327
42700,"Sebring-Avon Park, FL",103437,Metropolitan Statistical Area,Native American,2,2,0,No meaningful results,,,,291,36,327
42700,"Sebring-Avon Park, FL",103437,Metropolitan Statistical Area,AAPI,7,7,0,No meaningful results,,,,291,36,327
25060,"Gulfport-Biloxi, MS",412115,Metropolitan Statistical Area,Black,84,60,24,Regression equation needs to be tweaked,1.926152596,1.9,19,1241,110,1351
25060,"Gulfport-Biloxi, MS",412115,Metropolitan Statistical Area,Latino,49,45,4,Regression equation needs to be tweaked,0.554072462,0.6,6,1241,110,1351
25060,"Gulfport-Biloxi, MS",412115,Metropolitan Statistical Area,Native American,9,7,2,Regression equation needs to be tweaked,0.938850794,0.9,9,1241,110,1351
25060,"Gulfport-Biloxi, MS",412115,Metropolitan Statistical Area,AAPI,44,39,5,Regression equation needs to be tweaked,1.767259096,1.8,18,1241,110,1351
42620,"Searcy, AR",78762,Micropolitan Statistical Area,Black,1,1,0,No meaningful results,,,,271,14,285
42620,"Searcy, AR",78762,Micropolitan Statistical Area,Latino,1,1,0,No meaningful results,,,,271,14,285
42620,"Searcy, AR",78762,Micropolitan Statistical Area,Native American,1,1,0,No meaningful results,,,,271,14,285
42620,"Searcy, AR",78762,Micropolitan Statistical Area,AAPI,4,4,0,No meaningful results,,,,271,14,285
46660,"Valdosta, GA",145315,Metropolitan Statistical Area,Black,41,34,7,No meaningful results,,,,322,21,343
46660,"Valdosta, GA",145315,Metropolitan Statistical Area,Latino,19,13,6,No meaningful results,,,,322,21,343
46660,"Valdosta, GA",145315,Metropolitan Statistical Area,Native American,1,0,1,No meaningful results,,,,322,21,343
46660,"Valdosta, GA",145315,Metropolitan Statistical Area,AAPI,12,12,0,No meaningful results,,,,322,21,343
22180,"Fayetteville, NC",519101,Metropolitan Statistical Area,Black,231,188,43,Regression equation needs to be tweaked,2.128774704,2.1,21,921,63,984
22180,"Fayetteville, NC",519101,Metropolitan Statistical Area,Latino,163,135,28,Regression equation needs to be tweaked,2.532816652,2.5,25,921,63,984
22180,"Fayetteville, NC",519101,Metropolitan Statistical Area,Native American,19,17,2,Regression equation needs to be tweaked,2.343430252,2.3,23,921,63,984
22180,"Fayetteville, NC",519101,Metropolitan Statistical Area,AAPI,75,63,12,Regression equation needs to be tweaked,2.049535473,2,20,921,63,984
31260,"Lufkin, TX",87322,Micropolitan Statistical Area,Black,19,12,7,No meaningful results,,,,239,34,273
31260,"Lufkin, TX",87322,Micropolitan Statistical Area,Latino,47,38,9,No meaningful results,,,,239,34,273
31260,"Lufkin, TX",87322,Micropolitan Statistical Area,Native American,0,0,0,No meaningful results,,,,239,34,273
31260,"Lufkin, TX",87322,Micropolitan Statistical Area,AAPI,8,7,1,No meaningful results,,,,239,34,273
29180,"Lafayette, LA",489914,Metropolitan Statistical Area,Black,167,139,28,Regression equation needs to be tweaked,2.602110024,2.6,26,1677,67,1744
29180,"Lafayette, LA",489914,Metropolitan Statistical Area,Latino,41,41,0,Regression equation needs to be tweaked,4.15E-11,0,0,1677,67,1744
29180,"Lafayette, LA",489914,Metropolitan Statistical Area,Native American,5,4,1,Regression equation needs to be tweaked,2.499408026,2.5,25,1677,67,1744
29180,"Lafayette, LA",489914,Metropolitan Statistical Area,AAPI,69,65,4,Regression equation needs to be tweaked,0.892533117,0.9,9,1677,67,1744
26900,"Indianapolis-Carmel-Anderson, IN",2029472,Metropolitan Statistical Area,Black,1068,937,131,Statistcially significant disparity,2.427798991,2.4,24,16162,619,16781
26900,"Indianapolis-Carmel-Anderson, IN",2029472,Metropolitan Statistical Area,Latino,920,823,97,Statistcially significant disparity,2.04275246,2,20,16162,619,16781
26900,"Indianapolis-Carmel-Anderson, IN",2029472,Metropolitan Statistical Area,Native American,30,28,2,Not statistcially significant,1.652678128,1.7,17,16162,619,16781
26900,"Indianapolis-Carmel-Anderson, IN",2029472,Metropolitan Statistical Area,AAPI,1513,1372,141,Statistcially significant disparity,2.458710199,2.5,25,16162,619,16781
17660,"Coeur d'Alene, ID",157322,Metropolitan Statistical Area,Black,2,1,1,Regression equation needs to be tweaked,27.64439475,27.6,276,1908,103,2011
17660,"Coeur d'Alene, ID",157322,Metropolitan Statistical Area,Latino,58,57,1,Regression equation needs to be tweaked,0.587999451,0.6,6,1908,103,2011
17660,"Coeur d'Alene, ID",157322,Metropolitan Statistical Area,Native American,9,9,0,Regression equation needs to be tweaked,7.80E-07,0,0,1908,103,2011
17660,"Coeur d'Alene, ID",157322,Metropolitan Statistical Area,AAPI,29,28,1,Regression equation needs to be tweaked,0.105284002,0.1,1,1908,103,2011
47220,"Vineland-Bridgeton, NJ",151906,Metropolitan Statistical Area,Black,19,15,4,No meaningful results,,,,173,11,184
47220,"Vineland-Bridgeton, NJ",151906,Metropolitan Statistical Area,Latino,74,60,14,No meaningful results,,,,173,11,184
47220,"Vineland-Bridgeton, NJ",151906,Metropolitan Statistical Area,Native American,3,3,0,No meaningful results,,,,173,11,184
47220,"Vineland-Bridgeton, NJ",151906,Metropolitan Statistical Area,AAPI,10,9,1,No meaningful results,,,,173,11,184
26220,"Hood River, OR",23209,Micropolitan Statistical Area,Black,2,2,0,No meaningful results,,,,117,7,124
26220,"Hood River, OR",23209,Micropolitan Statistical Area,Latino,18,15,3,No meaningful results,,,,117,7,124
26220,"Hood River, OR",23209,Micropolitan Statistical Area,Native American,0,0,0,No meaningful results,,,,117,7,124
26220,"Hood River, OR",23209,Micropolitan Statistical Area,AAPI,5,5,0,No meaningful results,,,,117,7,124
42980,"Seymour, IN",44025,Micropolitan Statistical Area,Black,1,1,0,No meaningful results,,,,155,6,161
42980,"Seymour, IN",44025,Micropolitan Statistical Area,Latino,25,21,4,No meaningful results,,,,155,6,161
42980,"Seymour, IN",44025,Micropolitan Statistical Area,Native American,0,0,0,No meaningful results,,,,155,6,161
42980,"Seymour, IN",44025,Micropolitan Statistical Area,AAPI,4,2,2,No meaningful results,,,,155,6,161
30380,"Lewistown, PA",46276,Micropolitan Statistical Area,Black,0,0,0,No meaningful results,,,,153,10,163
30380,"Lewistown, PA",46276,Micropolitan Statistical Area,Latino,3,2,1,No meaningful results,,,,153,10,163
30380,"Lewistown, PA",46276,Micropolitan Statistical Area,Native American,0,0,0,No meaningful results,,,,153,10,163
30380,"Lewistown, PA",46276,Micropolitan Statistical Area,AAPI,0,0,0,No meaningful results,,,,153,10,163
41980,"San Juan-Bayamón-Caguas, PR",2100207,Metropolitan Statistical Area,Black,7,3,4,No meaningful results,,,,96,24,120
41980,"San Juan-Bayamón-Caguas, PR",2100207,Metropolitan Statistical Area,Latino,1973,1620,353,No meaningful results,,,,96,24,120
41980,"San Juan-Bayamón-Caguas, PR",2100207,Metropolitan Statistical Area,Native American,1,0,1,No meaningful results,,,,96,24,120
41980,"San Juan-Bayamón-Caguas, PR",2100207,Metropolitan Statistical Area,AAPI,19,13,6,No meaningful results,,,,96,24,120
32780,"Medford, OR",216574,Metropolitan Statistical Area,Black,9,7,2,No meaningful results,,,,1534,77,1611
32780,"Medford, OR",216574,Metropolitan Statistical Area,Latino,147,135,12,No meaningful results,,,,1534,77,1611
32780,"Medford, OR",216574,Metropolitan Statistical Area,Native American,15,15,0,No meaningful results,,,,1534,77,1611
32780,"Medford, OR",216574,Metropolitan Statistical Area,AAPI,47,46,1,No meaningful results,,,,1534,77,1611
21660,"Eugene-Springfield, OR",373340,Metropolitan Statistical Area,Black,20,18,2,No meaningful results,,,,2159,105,2264
21660,"Eugene-Springfield, OR",373340,Metropolitan Statistical Area,Latino,131,123,8,No meaningful results,,,,2159,105,2264
21660,"Eugene-Springfield, OR",373340,Metropolitan Statistical Area,Native American,22,21,1,No meaningful results,,,,2159,105,2264
21660,"Eugene-Springfield, OR",373340,Metropolitan Statistical Area,AAPI,105,99,6,No meaningful results,,,,2159,105,2264
10540,"Albany-Lebanon, OR",125048,Metropolitan Statistical Area,Black,7,7,0,No meaningful results,,,,722,41,763
10540,"Albany-Lebanon, OR",125048,Metropolitan Statistical Area,Latino,50,48,2,No meaningful results,,,,722,41,763
10540,"Albany-Lebanon, OR",125048,Metropolitan Statistical Area,Native American,13,11,2,No meaningful results,,,,722,41,763
10540,"Albany-Lebanon, OR",125048,Metropolitan Statistical Area,AAPI,21,20,1,No meaningful results,,,,722,41,763
39260,"Prineville, OR",23011,Micropolitan Statistical Area,Black,0,0,0,No meaningful results,,,,201,12,213
39260,"Prineville, OR",23011,Micropolitan Statistical Area,Latino,5,5,0,No meaningful results,,,,201,12,213
39260,"Prineville, OR",23011,Micropolitan Statistical Area,Native American,3,3,0,No meaningful results,,,,201,12,213
39260,"Prineville, OR",23011,Micropolitan Statistical Area,AAPI,1,1,0,No meaningful results,,,,201,12,213
46300,"Twin Falls, ID",108599,Metropolitan Statistical Area,Black,6,6,0,No meaningful results,,,,884,36,920
46300,"Twin Falls, ID",108599,Metropolitan Statistical Area,Latino,146,131,15,No meaningful results,,,,884,36,920
46300,"Twin Falls, ID",108599,Metropolitan Statistical Area,Native American,7,6,1,No meaningful results,,,,884,36,920
46300,"Twin Falls, ID",108599,Metropolitan Statistical Area,AAPI,7,6,1,No meaningful results,,,,884,36,920
18700,"Corvallis, OR",91107,Metropolitan Statistical Area,Black,2,2,0,No meaningful results,,,,500,17,517
18700,"Corvallis, OR",91107,Metropolitan Statistical Area,Latino,20,20,0,No meaningful results,,,,500,17,517
18700,"Corvallis, OR",91107,Metropolitan Statistical Area,Native American,3,2,1,No meaningful results,,,,500,17,517
18700,"Corvallis, OR",91107,Metropolitan Statistical Area,AAPI,28,25,3,No meaningful results,,,,500,17,517
28900,"Klamath Falls, OR",66921,Micropolitan Statistical Area,Black,1,1,0,No meaningful results,,,,320,24,344
28900,"Klamath Falls, OR",66921,Micropolitan Statistical Area,Latino,31,28,3,No meaningful results,,,,320,24,344
28900,"Klamath Falls, OR",66921,Micropolitan Statistical Area,Native American,10,6,4,No meaningful results,,,,320,24,344
28900,"Klamath Falls, OR",66921,Micropolitan Statistical Area,AAPI,4,4,0,No meaningful results,,,,320,24,344
24420,"Grants Pass, OR",86251,Metropolitan Statistical Area,Black,1,1,0,No meaningful results,,,,476,31,507
24420,"Grants Pass, OR",86251,Metropolitan Statistical Area,Latino,20,19,1,No meaningful results,,,,476,31,507
24420,"Grants Pass, OR",86251,Metropolitan Statistical Area,Native American,5,5,0,No meaningful results,,,,476,31,507
24420,"Grants Pass, OR",86251,Metropolitan Statistical Area,AAPI,6,6,0,No meaningful results,,,,476,31,507
45520,"The Dalles, OR",26130,Micropolitan Statistical Area,Black,0,0,0,No meaningful results,,,,100,7,107
45520,"The Dalles, OR",26130,Micropolitan Statistical Area,Latino,13,11,2,No meaningful results,,,,100,7,107
45520,"The Dalles, OR",26130,Micropolitan Statistical Area,Native American,0,0,0,No meaningful results,,,,100,7,107
45520,"The Dalles, OR",26130,Micropolitan Statistical Area,AAPI,2,2,0,No meaningful results,,,,100,7,107
40700,"Roseburg, OR",109114,Micropolitan Statistical Area,Black,2,2,0,No meaningful results,,,,512,29,541
40700,"Roseburg, OR",109114,Micropolitan Statistical Area,Latino,20,19,1,No meaningful results,,,,512,29,541
40700,"Roseburg, OR",109114,Micropolitan Statistical Area,Native American,6,5,1,No meaningful results,,,,512,29,541
40700,"Roseburg, OR",109114,Micropolitan Statistical Area,AAPI,7,7,0,No meaningful results,,,,512,29,541
25840,"Hermiston-Pendleton, OR",88432,Micropolitan Statistical Area,Black,0,0,0,No meaningful results,,,,306,21,327
25840,"Hermiston-Pendleton, OR",88432,Micropolitan Statistical Area,Latino,77,67,10,No meaningful results,,,,306,21,327
25840,"Hermiston-Pendleton, OR",88432,Micropolitan Statistical Area,Native American,5,5,0,No meaningful results,,,,306,21,327
25840,"Hermiston-Pendleton, OR",88432,Micropolitan Statistical Area,AAPI,7,6,1,No meaningful results,,,,306,21,327
29260,"La Grande, OR",26337,Micropolitan Statistical Area,Black,1,1,0,No meaningful results,,,,136,11,147
29260,"La Grande, OR",26337,Micropolitan Statistical Area,Latino,6,3,3,No meaningful results,,,,136,11,147
29260,"La Grande, OR",26337,Micropolitan Statistical Area,Native American,1,0,1,No meaningful results,,,,136,11,147
29260,"La Grande, OR",26337,Micropolitan Statistical Area,AAPI,3,3,0,No meaningful results,,,,136,11,147
43740,"Somerset, PA",74361,Micropolitan Statistical Area,Black,1,1,0,No meaningful results,,,,221,25,246
43740,"Somerset, PA",74361,Micropolitan Statistical Area,Latino,4,3,1,No meaningful results,,,,221,25,246
43740,"Somerset, PA",74361,Micropolitan Statistical Area,Native American,0,0,0,No meaningful results,,,,221,25,246
43740,"Somerset, PA",74361,Micropolitan Statistical Area,AAPI,3,3,0,No meaningful results,,,,221,25,246
26500,"Huntingdon, PA",45369,Micropolitan Statistical Area,Black,1,1,0,No meaningful results,,,,117,10,127
26500,"Huntingdon, PA",45369,Micropolitan Statistical Area,Latino,2,1,1,No meaningful results,,,,117,10,127
26500,"Huntingdon, PA",45369,Micropolitan Statistical Area,Native American,0,0,0,No meaningful results,,,,117,10,127
26500,"Huntingdon, PA",45369,Micropolitan Statistical Area,AAPI,1,0,1,No meaningful results,,,,117,10,127
27780,"Johnstown, PA",133009,Metropolitan Statistical Area,Black,4,4,0,No meaningful results,,,,351,39,390
27780,"Johnstown, PA",133009,Metropolitan Statistical Area,Latino,5,5,0,No meaningful results,,,,351,39,390
27780,"Johnstown, PA",133009,Metropolitan Statistical Area,Native American,1,1,0,No meaningful results,,,,351,39,390
27780,"Johnstown, PA",133009,Metropolitan Statistical Area,AAPI,3,3,0,No meaningful results,,,,351,39,390
26860,"Indiana, PA",85032,Micropolitan Statistical Area,Black,0,0,0,No meaningful results,,,,244,15,259
26860,"Indiana, PA",85032,Micropolitan Statistical Area,Latino,2,1,1,No meaningful results,,,,244,15,259
26860,"Indiana, PA",85032,Micropolitan Statistical Area,Native American,1,0,1,No meaningful results,,,,244,15,259
26860,"Indiana, PA",85032,Micropolitan Statistical Area,AAPI,1,1,0,No meaningful results,,,,244,15,259
15540,"Burlington-South Burlington, VT",218784,Metropolitan Statistical Area,Black,20,20,0,No meaningful results,,,,1596,56,1652
15540,"Burlington-South Burlington, VT",218784,Metropolitan Statistical Area,Latino,25,21,4,No meaningful results,,,,1596,56,1652
15540,"Burlington-South Burlington, VT",218784,Metropolitan Statistical Area,Native American,7,6,1,No meaningful results,,,,1596,56,1652
15540,"Burlington-South Burlington, VT",218784,Metropolitan Statistical Area,AAPI,72,69,3,No meaningful results,,,,1596,56,1652
19060,"Cumberland, MD-WV",98612,Metropolitan Statistical Area,Black,2,2,0,No meaningful results,,,,270,8,278
19060,"Cumberland, MD-WV",98612,Metropolitan Statistical Area,Latino,2,2,0,No meaningful results,,,,270,8,278
19060,"Cumberland, MD-WV",98612,Metropolitan Statistical Area,Native American,0,0,0,No meaningful results,,,,270,8,278
19060,"Cumberland, MD-WV",98612,Metropolitan Statistical Area,AAPI,1,1,0,No meaningful results,,,,270,8,278
29740,"Las Cruces, NM",216069,Metropolitan Statistical Area,Black,7,7,0,No meaningful results,,,,435,16,451
29740,"Las Cruces, NM",216069,Metropolitan Statistical Area,Latino,359,334,25,No meaningful results,,,,435,16,451
29740,"Las Cruces, NM",216069,Metropolitan Statistical Area,Native American,6,6,0,No meaningful results,,,,435,16,451
29740,"Las Cruces, NM",216069,Metropolitan Statistical Area,AAPI,21,21,0,No meaningful results,,,,435,16,451
35700,"Nogales, AZ",46480,Micropolitan Statistical Area,Black,1,1,0,No meaningful results,,,,53,8,61
35700,"Nogales, AZ",46480,Micropolitan Statistical Area,Latino,74,68,6,No meaningful results,,,,53,8,61
35700,"Nogales, AZ",46480,Micropolitan Statistical Area,Native American,0,0,0,No meaningful results,,,,53,8,61
35700,"Nogales, AZ",46480,Micropolitan Statistical Area,AAPI,6,6,0,No meaningful results,,,,53,8,61
26020,"Hobbs, NM",70277,Micropolitan Statistical Area,Black,1,1,0,No meaningful results,,,,99,6,105
26020,"Hobbs, NM",70277,Micropolitan Statistical Area,Latino,101,93,8,No meaningful results,,,,99,6,105
26020,"Hobbs, NM",70277,Micropolitan Statistical Area,Native American,2,2,0,No meaningful results,,,,99,6,105
26020,"Hobbs, NM",70277,Micropolitan Statistical Area,AAPI,5,5,0,No meaningful results,,,,99,6,105
40760,"Ruidoso, NM",19461,Micropolitan Statistical Area,Black,0,0,0,No meaningful results,,,,73,7,80
40760,"Ruidoso, NM",19461,Micropolitan Statistical Area,Latino,16,15,1,No meaningful results,,,,73,7,80
40760,"Ruidoso, NM",19461,Micropolitan Statistical Area,Native American,2,2,0,No meaningful results,,,,73,7,80
40760,"Ruidoso, NM",19461,Micropolitan Statistical Area,AAPI,1,1,0,No meaningful results,,,,73,7,80
43500,"Silver City, NM",27669,Micropolitan Statistical Area,Black,0,0,0,No meaningful results,,,,50,2,52
43500,"Silver City, NM",27669,Micropolitan Statistical Area,Latino,5,5,0,No meaningful results,,,,50,2,52
43500,"Silver City, NM",27669,Micropolitan Statistical Area,Native American,0,0,0,No meaningful results,,,,50,2,52
43500,"Silver City, NM",27669,Micropolitan Statistical Area,AAPI,1,1,0,No meaningful results,,,,50,2,52
23820,"Gardnerville Ranchos, NV",48132,Micropolitan Statistical Area,Black,3,2,1,Regression equation needs to be tweaked,1.98278221,2,20,357,15,372
23820,"Gardnerville Ranchos, NV",48132,Micropolitan Statistical Area,Latino,30,25,5,Regression equation needs to be tweaked,4.925799717,4.9,49,357,15,372
23820,"Gardnerville Ranchos, NV",48132,Micropolitan Statistical Area,Native American,2,2,0,Regression equation needs to be tweaked,2.64E-08,0,0,357,15,372
23820,"Gardnerville Ranchos, NV",48132,Micropolitan Statistical Area,AAPI,6,6,0,Regression equation needs to be tweaked,5.43E-08,0,0,357,15,372
40740,"Roswell, NM",65144,Micropolitan Statistical Area,Black,2,2,0,No meaningful results,,,,125,12,137
40740,"Roswell, NM",65144,Micropolitan Statistical Area,Latino,100,87,13,No meaningful results,,,,125,12,137
40740,"Roswell, NM",65144,Micropolitan Statistical Area,Native American,2,2,0,No meaningful results,,,,125,12,137
40740,"Roswell, NM",65144,Micropolitan Statistical Area,AAPI,7,5,2,No meaningful results,,,,125,12,137
12700,"Barnstable Town, MA",213496,Metropolitan Statistical Area,Black,41,33,8,Regression equation needs to be tweaked,5.50719287,5.5,55,1329,89,1418
12700,"Barnstable Town, MA",213496,Metropolitan Statistical Area,Latino,74,70,4,Regression equation needs to be tweaked,1.140624563,1.1,11,1329,89,1418
12700,"Barnstable Town, MA",213496,Metropolitan Statistical Area,Native American,4,4,0,Regression equation needs to be tweaked,2.40E-08,0,0,1329,89,1418
12700,"Barnstable Town, MA",213496,Metropolitan Statistical Area,AAPI,27,25,2,Regression equation needs to be tweaked,0.69923561,0.7,7,1329,89,1418
38340,"Pittsfield, MA",126425,Metropolitan Statistical Area,Black,16,14,2,No meaningful results,,,,767,57,824
38340,"Pittsfield, MA",126425,Metropolitan Statistical Area,Latino,68,63,5,No meaningful results,,,,767,57,824
38340,"Pittsfield, MA",126425,Metropolitan Statistical Area,Native American,1,1,0,No meaningful results,,,,767,57,824
38340,"Pittsfield, MA",126425,Metropolitan Statistical Area,AAPI,18,16,2,No meaningful results,,,,767,57,824
30280,"Lewisburg, TN",32965,Micropolitan Statistical Area,Black,7,6,1,No meaningful results,,,,199,14,213
30280,"Lewisburg, TN",32965,Micropolitan Statistical Area,Latino,18,15,3,No meaningful results,,,,199,14,213
30280,"Lewisburg, TN",32965,Micropolitan Statistical Area,Native American,1,1,0,No meaningful results,,,,199,14,213
30280,"Lewisburg, TN",32965,Micropolitan Statistical Area,AAPI,1,0,1,No meaningful results,,,,199,14,213
18980,"Cullman, AL",82853,Micropolitan Statistical Area,Black,2,2,0,No meaningful results,,,,267,21,288
18980,"Cullman, AL",82853,Micropolitan Statistical Area,Latino,10,7,3,No meaningful results,,,,267,21,288
18980,"Cullman, AL",82853,Micropolitan Statistical Area,Native American,0,0,0,No meaningful results,,,,267,21,288
18980,"Cullman, AL",82853,Micropolitan Statistical Area,AAPI,4,3,1,No meaningful results,,,,267,21,288
15140,"Brownsville, TN",17623,Micropolitan Statistical Area,Black,3,3,0,No meaningful results,,,,12,3,15
15140,"Brownsville, TN",17623,Micropolitan Statistical Area,Latino,0,0,0,No meaningful results,,,,12,3,15
15140,"Brownsville, TN",17623,Micropolitan Statistical Area,Native American,0,0,0,No meaningful results,,,,12,3,15
15140,"Brownsville, TN",17623,Micropolitan Statistical Area,AAPI,0,0,0,No meaningful results,,,,12,3,15
43180,"Shelbyville, TN",48292,Micropolitan Statistical Area,Black,4,4,0,No meaningful results,,,,217,13,230
43180,"Shelbyville, TN",48292,Micropolitan Statistical Area,Latino,29,27,2,No meaningful results,,,,217,13,230
43180,"Shelbyville, TN",48292,Micropolitan Statistical Area,Native American,1,1,0,No meaningful results,,,,217,13,230
43180,"Shelbyville, TN",48292,Micropolitan Statistical Area,AAPI,6,6,0,No meaningful results,,,,217,13,230
21460,"Enterprise, AL",51662,Micropolitan Statistical Area,Black,7,7,0,No meaningful results,,,,129,3,132
21460,"Enterprise, AL",51662,Micropolitan Statistical Area,Latino,8,7,1,No meaningful results,,,,129,3,132
21460,"Enterprise, AL",51662,Micropolitan Statistical Area,Native American,2,2,0,No meaningful results,,,,129,3,132
21460,"Enterprise, AL",51662,Micropolitan Statistical Area,AAPI,6,5,1,No meaningful results,,,,129,3,132
29980,"Lawrenceburg, TN",43390,Micropolitan Statistical Area,Black,0,0,0,No meaningful results,,,,130,11,141
29980,"Lawrenceburg, TN",43390,Micropolitan Statistical Area,Latino,3,3,0,No meaningful results,,,,130,11,141
29980,"Lawrenceburg, TN",43390,Micropolitan Statistical Area,Native American,0,0,0,No meaningful results,,,,130,11,141
29980,"Lawrenceburg, TN",43390,Micropolitan Statistical Area,AAPI,2,2,0,No meaningful results,,,,130,11,141
12940,"Baton Rouge, LA",854318,Metropolitan Statistical Area,Black,595,512,83,Statistcially significant disparity,2.412729827,2.4,24,3633,104,3737
12940,"Baton Rouge, LA",854318,Metropolitan Statistical Area,Latino,155,143,12,Not statistcially significant,1.643748238,1.6,16,3633,104,3737
12940,"Baton Rouge, LA",854318,Metropolitan Statistical Area,Native American,11,10,1,Not statistcially significant,3.254800559,3.3,33,3633,104,3737
12940,"Baton Rouge, LA",854318,Metropolitan Statistical Area,AAPI,181,169,12,Not statistcially significant,1.785515914,1.8,18,3633,104,3737
25220,"Hammond, LA",132057,Metropolitan Statistical Area,Black,32,28,4,No meaningful results,,,,423,15,438
25220,"Hammond, LA",132057,Metropolitan Statistical Area,Latino,18,16,2,No meaningful results,,,,423,15,438
25220,"Hammond, LA",132057,Metropolitan Statistical Area,Native American,1,1,0,No meaningful results,,,,423,15,438
25220,"Hammond, LA",132057,Metropolitan Statistical Area,AAPI,7,6,1,No meaningful results,,,,423,15,438
43340,"Shreveport-Bossier City, LA",399619,Metropolitan Statistical Area,Black,172,140,32,Regression equation needs to be tweaked,2.046727225,2,20,1040,47,1087
43340,"Shreveport-Bossier City, LA",399619,Metropolitan Statistical Area,Latino,34,28,6,Regression equation needs to be tweaked,3.499404218,3.5,35,1040,47,1087
43340,"Shreveport-Bossier City, LA",399619,Metropolitan Statistical Area,Native American,3,2,1,Regression equation needs to be tweaked,0.316599424,0.3,3,1040,47,1087
43340,"Shreveport-Bossier City, LA",399619,Metropolitan Statistical Area,AAPI,43,39,4,Regression equation needs to be tweaked,3.454675599,3.5,35,1040,47,1087
27340,"Jacksonville, NC",195069,Metropolitan Statistical Area,Black,25,20,5,No meaningful results,,,,453,34,487
27340,"Jacksonville, NC",195069,Metropolitan Statistical Area,Latino,28,27,1,No meaningful results,,,,453,34,487
27340,"Jacksonville, NC",195069,Metropolitan Statistical Area,Native American,3,3,0,No meaningful results,,,,453,34,487
27340,"Jacksonville, NC",195069,Metropolitan Statistical Area,AAPI,25,22,3,No meaningful results,,,,453,34,487
24780,"Greenville, NC",178433,Metropolitan Statistical Area,Black,159,137,22,Regression equation needs to be tweaked,2.595382075,2.6,26,847,33,880
24780,"Greenville, NC",178433,Metropolitan Statistical Area,Latino,56,48,8,Regression equation needs to be tweaked,4.501798065,4.5,45,847,33,880
24780,"Greenville, NC",178433,Metropolitan Statistical Area,Native American,4,4,0,Regression equation needs to be tweaked,8.51E-09,0,0,847,33,880
24780,"Greenville, NC",178433,Metropolitan Statistical Area,AAPI,43,41,2,Regression equation needs to be tweaked,0.195749828,0.2,2,847,33,880
47460,"Walla Walla, WA",60365,Metropolitan Statistical Area,Black,4,3,1,No meaningful results,,,,311,22,333
47460,"Walla Walla, WA",60365,Metropolitan Statistical Area,Latino,46,44,2,No meaningful results,,,,311,22,333
47460,"Walla Walla, WA",60365,Metropolitan Statistical Area,Native American,1,1,0,No meaningful results,,,,311,22,333
47460,"Walla Walla, WA",60365,Metropolitan Statistical Area,AAPI,4,4,0,No meaningful results,,,,311,22,333
34140,"Moscow, ID",39505,Micropolitan Statistical Area,Black,2,1,1,No meaningful results,,,,287,14,301
34140,"Moscow, ID",39505,Micropolitan Statistical Area,Latino,8,8,0,No meaningful results,,,,287,14,301
34140,"Moscow, ID",39505,Micropolitan Statistical Area,Native American,2,1,1,No meaningful results,,,,287,14,301
34140,"Moscow, ID",39505,Micropolitan Statistical Area,AAPI,6,6,0,No meaningful results,,,,287,14,301
32580,"McAllen-Edinburg-Mission, TX",855176,Metropolitan Statistical Area,Black,12,9,3,Regression equation needs to be tweaked,5.375305881,5.4,54,219,21,240
32580,"McAllen-Edinburg-Mission, TX",855176,Metropolitan Statistical Area,Latino,1217,1067,150,Regression equation needs to be tweaked,1.65544933,1.7,17,219,21,240
32580,"McAllen-Edinburg-Mission, TX",855176,Metropolitan Statistical Area,Native American,2,2,0,Regression equation needs to be tweaked,4.04E-05,0,0,219,21,240
32580,"McAllen-Edinburg-Mission, TX",855176,Metropolitan Statistical Area,AAPI,48,42,6,Regression equation needs to be tweaked,2.426982379,2.4,24,219,21,240
11260,"Anchorage, AK",398900,Metropolitan Statistical Area,Black,41,37,4,Regression equation needs to be tweaked,2.163398097,2.2,22,2084,68,2152
11260,"Anchorage, AK",398900,Metropolitan Statistical Area,Latino,114,109,5,Regression equation needs to be tweaked,1.136140983,1.1,11,2084,68,2152
11260,"Anchorage, AK",398900,Metropolitan Statistical Area,Native American,156,153,3,Regression equation needs to be tweaked,0.316872071,0.3,3,2084,68,2152
11260,"Anchorage, AK",398900,Metropolitan Statistical Area,AAPI,177,163,14,Regression equation needs to be tweaked,2.092115157,2.1,21,2084,68,2152
26820,"Idaho Falls, ID",145507,Metropolitan Statistical Area,Black,6,5,1,Regression equation needs to be tweaked,6.486824374,6.5,65,1389,49,1438
26820,"Idaho Falls, ID",145507,Metropolitan Statistical Area,Latino,113,109,4,Regression equation needs to be tweaked,1.060113583,1.1,11,1389,49,1438
26820,"Idaho Falls, ID",145507,Metropolitan Statistical Area,Native American,5,5,0,Regression equation needs to be tweaked,1.86E-08,0,0,1389,49,1438
26820,"Idaho Falls, ID",145507,Metropolitan Statistical Area,AAPI,26,26,0,Regression equation needs to be tweaked,1.60E-10,0,0,1389,49,1438
46340,"Tyler, TX",227449,Metropolitan Statistical Area,Black,67,58,9,Regression equation needs to be tweaked,2.017739121,2,20,1173,73,1246
46340,"Tyler, TX",227449,Metropolitan Statistical Area,Latino,186,158,28,Regression equation needs to be tweaked,1.349211505,1.3,13,1173,73,1246
46340,"Tyler, TX",227449,Metropolitan Statistical Area,Native American,9,8,1,Regression equation needs to be tweaked,2.906688337,2.9,29,1173,73,1246
46340,"Tyler, TX",227449,Metropolitan Statistical Area,AAPI,49,41,8,Regression equation needs to be tweaked,1.104227067,1.1,11,1173,73,1246
31020,"Longview, WA",106778,Metropolitan Statistical Area,Black,4,4,0,No meaningful results,,,,632,38,670
31020,"Longview, WA",106778,Metropolitan Statistical Area,Latino,28,23,5,No meaningful results,,,,632,38,670
31020,"Longview, WA",106778,Metropolitan Statistical Area,Native American,7,7,0,No meaningful results,,,,632,38,670
31020,"Longview, WA",106778,Metropolitan Statistical Area,AAPI,15,14,1,No meaningful results,,,,632,38,670
33220,"Midland, MI",83355,Metropolitan Statistical Area,Black,2,2,0,No meaningful results,,,,680,35,715
33220,"Midland, MI",83355,Metropolitan Statistical Area,Latino,18,18,0,No meaningful results,,,,680,35,715
33220,"Midland, MI",83355,Metropolitan Statistical Area,Native American,2,1,1,No meaningful results,,,,680,35,715
33220,"Midland, MI",83355,Metropolitan Statistical Area,AAPI,8,8,0,No meaningful results,,,,680,35,715
13020,"Bay City, MI",104104,Metropolitan Statistical Area,Black,0,0,0,No meaningful results,,,,527,19,546
13020,"Bay City, MI",104104,Metropolitan Statistical Area,Latino,13,12,1,No meaningful results,,,,527,19,546
13020,"Bay City, MI",104104,Metropolitan Statistical Area,Native American,1,1,0,No meaningful results,,,,527,19,546
13020,"Bay City, MI",104104,Metropolitan Statistical Area,AAPI,3,3,0,No meaningful results,,,,527,19,546
30100,"Lebanon, NH-VT",217064,Micropolitan Statistical Area,Black,6,3,3,Regression equation needs to be tweaked,3.661575522,3.7,37,687,107,794
30100,"Lebanon, NH-VT",217064,Micropolitan Statistical Area,Latino,26,22,4,Regression equation needs to be tweaked,0.581152004,0.6,6,687,107,794
30100,"Lebanon, NH-VT",217064,Micropolitan Statistical Area,Native American,1,1,0,Regression equation needs to be tweaked,3.59E-09,0,0,687,107,794
30100,"Lebanon, NH-VT",217064,Micropolitan Statistical Area,AAPI,30,25,5,Regression equation needs to be tweaked,1.488552543,1.5,15,687,107,794
30860,"Logan, UT-ID",137629,Metropolitan Statistical Area,Black,3,3,0,No meaningful results,,,,1022,42,1064
30860,"Logan, UT-ID",137629,Metropolitan Statistical Area,Latino,76,72,4,No meaningful results,,,,1022,42,1064
30860,"Logan, UT-ID",137629,Metropolitan Statistical Area,Native American,5,5,0,No meaningful results,,,,1022,42,1064
30860,"Logan, UT-ID",137629,Metropolitan Statistical Area,AAPI,28,27,1,No meaningful results,,,,1022,42,1064
21220,"Elko, NV",54156,Micropolitan Statistical Area,Black,2,2,0,No meaningful results,,,,259,11,270
21220,"Elko, NV",54156,Micropolitan Statistical Area,Latino,38,31,7,No meaningful results,,,,259,11,270
21220,"Elko, NV",54156,Micropolitan Statistical Area,Native American,2,2,0,No meaningful results,,,,259,11,270
21220,"Elko, NV",54156,Micropolitan Statistical Area,AAPI,4,3,1,No meaningful results,,,,259,11,270
12740,"Barre, VT",58350,Micropolitan Statistical Area,Black,4,3,1,No meaningful results,,,,367,26,393
12740,"Barre, VT",58350,Micropolitan Statistical Area,Latino,10,8,2,No meaningful results,,,,367,26,393
12740,"Barre, VT",58350,Micropolitan Statistical Area,Native American,3,3,0,No meaningful results,,,,367,26,393
12740,"Barre, VT",58350,Micropolitan Statistical Area,AAPI,3,3,0,No meaningful results,,,,367,26,393
11980,"Athens, TX",81070,Micropolitan Statistical Area,Black,7,5,2,No meaningful results,,,,273,28,301
11980,"Athens, TX",81070,Micropolitan Statistical Area,Latino,19,14,5,No meaningful results,,,,273,28,301
11980,"Athens, TX",81070,Micropolitan Statistical Area,Native American,2,2,0,No meaningful results,,,,273,28,301
11980,"Athens, TX",81070,Micropolitan Statistical Area,AAPI,3,2,1,No meaningful results,,,,273,28,301
30980,"Longview, TX",284796,Metropolitan Statistical Area,Black,58,43,15,No meaningful results,,,,1049,95,1144
30980,"Longview, TX",284796,Metropolitan Statistical Area,Latino,155,131,24,No meaningful results,,,,1049,95,1144
30980,"Longview, TX",284796,Metropolitan Statistical Area,Native American,8,6,2,No meaningful results,,,,1049,95,1144
30980,"Longview, TX",284796,Metropolitan Statistical Area,AAPI,24,16,8,No meaningful results,,,,1049,95,1144
15180,"Brownsville-Harlingen, TX",421666,Metropolitan Statistical Area,Black,7,7,0,No meaningful results,,,,155,17,172
15180,"Brownsville-Harlingen, TX",421666,Metropolitan Statistical Area,Latino,637,547,90,No meaningful results,,,,155,17,172
15180,"Brownsville-Harlingen, TX",421666,Metropolitan Statistical Area,Native American,2,1,1,No meaningful results,,,,155,17,172
15180,"Brownsville-Harlingen, TX",421666,Metropolitan Statistical Area,AAPI,18,15,3,No meaningful results,,,,155,17,172
22140,"Farmington, NM",126515,Metropolitan Statistical Area,Black,3,3,0,No meaningful results,,,,194,13,207
22140,"Farmington, NM",126515,Metropolitan Statistical Area,Latino,50,47,3,No meaningful results,,,,194,13,207
22140,"Farmington, NM",126515,Metropolitan Statistical Area,Native American,16,15,1,No meaningful results,,,,194,13,207
22140,"Farmington, NM",126515,Metropolitan Statistical Area,AAPI,7,7,0,No meaningful results,,,,194,13,207
27140,"Jackson, MS",597727,Metropolitan Statistical Area,Black,410,354,56,Not statistcially significant,1.159356192,1.2,12,2204,99,2303
27140,"Jackson, MS",597727,Metropolitan Statistical Area,Latino,50,45,5,Not statistcially significant,2.053099052,2.1,21,2204,99,2303
27140,"Jackson, MS",597727,Metropolitan Statistical Area,Native American,9,7,2,Not statistcially significant,2.201355214,2.2,22,2204,99,2303
27140,"Jackson, MS",597727,Metropolitan Statistical Area,AAPI,90,80,10,Not statistcially significant,1.931688629,1.9,19,2204,99,2303
41820,"Sanford, NC",60481,Micropolitan Statistical Area,Black,13,11,2,No meaningful results,,,,234,17,251
41820,"Sanford, NC",60481,Micropolitan Statistical Area,Latino,39,36,3,No meaningful results,,,,234,17,251
41820,"Sanford, NC",60481,Micropolitan Statistical Area,Native American,1,0,1,No meaningful results,,,,234,17,251
41820,"Sanford, NC",60481,Micropolitan Statistical Area,AAPI,4,4,0,No meaningful results,,,,234,17,251
18580,"Corpus Christi, TX",428548,Metropolitan Statistical Area,Black,40,36,4,No meaningful results,,,,913,63,976
18580,"Corpus Christi, TX",428548,Metropolitan Statistical Area,Latino,624,554,70,No meaningful results,,,,913,63,976
18580,"Corpus Christi, TX",428548,Metropolitan Statistical Area,Native American,4,4,0,No meaningful results,,,,913,63,976
18580,"Corpus Christi, TX",428548,Metropolitan Statistical Area,AAPI,73,68,5,No meaningful results,,,,913,63,976
13540,"Bennington, VT",35746,Micropolitan Statistical Area,Black,0,0,0,No meaningful results,,,,92,15,107
13540,"Bennington, VT",35746,Micropolitan Statistical Area,Latino,3,2,1,No meaningful results,,,,92,15,107
13540,"Bennington, VT",35746,Micropolitan Statistical Area,Native American,1,1,0,No meaningful results,,,,92,15,107
13540,"Bennington, VT",35746,Micropolitan Statistical Area,AAPI,0,0,0,No meaningful results,,,,92,15,107
23060,"Fort Wayne, IN",406305,Metropolitan Statistical Area,Black,162,151,11,Regression equation needs to be tweaked,1.455149612,1.5,15,3669,112,3781
23060,"Fort Wayne, IN",406305,Metropolitan Statistical Area,Latino,166,152,14,Regression equation needs to be tweaked,2.34520922,2.3,23,3669,112,3781
23060,"Fort Wayne, IN",406305,Metropolitan Statistical Area,Native American,10,9,1,Regression equation needs to be tweaked,7.068909248,7.1,71,3669,112,3781
23060,"Fort Wayne, IN",406305,Metropolitan Statistical Area,AAPI,229,211,18,Regression equation needs to be tweaked,2.153976333,2.2,22,3669,112,3781
44540,"Sterling, CO",22380,Micropolitan Statistical Area,Black,1,1,0,No meaningful results,,,,64,5,69
44540,"Sterling, CO",22380,Micropolitan Statistical Area,Latino,6,4,2,No meaningful results,,,,64,5,69
44540,"Sterling, CO",22380,Micropolitan Statistical Area,Native American,1,1,0,No meaningful results,,,,64,5,69
44540,"Sterling, CO",22380,Micropolitan Statistical Area,AAPI,2,1,1,No meaningful results,,,,64,5,69
18180,"Concord, NH",149917,Micropolitan Statistical Area,Black,8,6,2,No meaningful results,,,,1042,58,1100
18180,"Concord, NH",149917,Micropolitan Statistical Area,Latino,21,18,3,No meaningful results,,,,1042,58,1100
18180,"Concord, NH",149917,Micropolitan Statistical Area,Native American,2,2,0,No meaningful results,,,,1042,58,1100
18180,"Concord, NH",149917,Micropolitan Statistical Area,AAPI,20,17,3,No meaningful results,,,,1042,58,1100
49020,"Winchester, VA-WV",137621,Metropolitan Statistical Area,Black,33,32,1,No meaningful results,,,,843,31,874
49020,"Winchester, VA-WV",137621,Metropolitan Statistical Area,Latino,98,91,7,No meaningful results,,,,843,31,874
49020,"Winchester, VA-WV",137621,Metropolitan Statistical Area,Native American,4,4,0,No meaningful results,,,,843,31,874
49020,"Winchester, VA-WV",137621,Metropolitan Statistical Area,AAPI,30,27,3,No meaningful results,,,,843,31,874
43300,"Sherman-Denison, TX",131014,Metropolitan Statistical Area,Black,14,10,4,Regression equation needs to be tweaked,7.620328973,7.6,76,761,44,805
43300,"Sherman-Denison, TX",131014,Metropolitan Statistical Area,Latino,80,68,12,Regression equation needs to be tweaked,1.861767699,1.9,19,761,44,805
43300,"Sherman-Denison, TX",131014,Metropolitan Statistical Area,Native American,11,10,1,Regression equation needs to be tweaked,2.821216105,2.8,28,761,44,805
43300,"Sherman-Denison, TX",131014,Metropolitan Statistical Area,AAPI,9,9,0,Regression equation needs to be tweaked,4.70E-09,0,0,761,44,805
15700,"Cambridge, MD",32138,Micropolitan Statistical Area,Black,9,8,1,No meaningful results,,,,82,7,89
15700,"Cambridge, MD",32138,Micropolitan Statistical Area,Latino,6,4,2,No meaningful results,,,,82,7,89
15700,"Cambridge, MD",32138,Micropolitan Statistical Area,Native American,0,0,0,No meaningful results,,,,82,7,89
15700,"Cambridge, MD",32138,Micropolitan Statistical Area,AAPI,3,2,1,No meaningful results,,,,82,7,89
22420,"Flint, MI",407875,Metropolitan Statistical Area,Black,88,80,8,No meaningful results,,,,1918,80,1998
22420,"Flint, MI",407875,Metropolitan Statistical Area,Latino,32,30,2,No meaningful results,,,,1918,80,1998
22420,"Flint, MI",407875,Metropolitan Statistical Area,Native American,6,6,0,No meaningful results,,,,1918,80,1998
22420,"Flint, MI",407875,Metropolitan Statistical Area,AAPI,27,26,1,No meaningful results,,,,1918,80,1998
15680,"California-Lexington Park, MD",112290,Metropolitan Statistical Area,Black,30,25,5,No meaningful results,,,,500,24,524
15680,"California-Lexington Park, MD",112290,Metropolitan Statistical Area,Latino,18,18,0,No meaningful results,,,,500,24,524
15680,"California-Lexington Park, MD",112290,Metropolitan Statistical Area,Native American,2,2,0,No meaningful results,,,,500,24,524
15680,"California-Lexington Park, MD",112290,Metropolitan Statistical Area,AAPI,17,16,1,No meaningful results,,,,500,24,524
16820,"Charlottesville, VA",215445,Metropolitan Statistical Area,Black,55,53,2,No meaningful results,,,,1564,50,1614
16820,"Charlottesville, VA",215445,Metropolitan Statistical Area,Latino,52,49,3,No meaningful results,,,,1564,50,1614
16820,"Charlottesville, VA",215445,Metropolitan Statistical Area,Native American,3,3,0,No meaningful results,,,,1564,50,1614
16820,"Charlottesville, VA",215445,Metropolitan Statistical Area,AAPI,118,110,8,No meaningful results,,,,1564,50,1614
40860,"Rutland, VT",58892,Micropolitan Statistical Area,Black,1,1,0,No meaningful results,,,,170,29,199
40860,"Rutland, VT",58892,Micropolitan Statistical Area,Latino,5,4,1,No meaningful results,,,,170,29,199
40860,"Rutland, VT",58892,Micropolitan Statistical Area,Native American,1,1,0,No meaningful results,,,,170,29,199
40860,"Rutland, VT",58892,Micropolitan Statistical Area,AAPI,1,1,0,No meaningful results,,,,170,29,199
30340,"Lewiston-Auburn, ME",107602,Metropolitan Statistical Area,Black,6,5,1,No meaningful results,,,,390,28,418
30340,"Lewiston-Auburn, ME",107602,Metropolitan Statistical Area,Latino,7,6,1,No meaningful results,,,,390,28,418
30340,"Lewiston-Auburn, ME",107602,Metropolitan Statistical Area,Native American,5,4,1,No meaningful results,,,,390,28,418
30340,"Lewiston-Auburn, ME",107602,Metropolitan Statistical Area,AAPI,2,1,1,No meaningful results,,,,390,28,418
34380,"Mount Pleasant, MI",70688,Micropolitan Statistical Area,Black,8,8,0,No meaningful results,,,,300,33,333
34380,"Mount Pleasant, MI",70688,Micropolitan Statistical Area,Latino,7,5,2,No meaningful results,,,,300,33,333
34380,"Mount Pleasant, MI",70688,Micropolitan Statistical Area,Native American,3,3,0,No meaningful results,,,,300,33,333
34380,"Mount Pleasant, MI",70688,Micropolitan Statistical Area,AAPI,5,5,0,No meaningful results,,,,300,33,333
40980,"Saginaw, MI",191821,Metropolitan Statistical Area,Black,63,59,4,No meaningful results,,,,765,27,792
40980,"Saginaw, MI",191821,Metropolitan Statistical Area,Latino,35,30,5,No meaningful results,,,,765,27,792
40980,"Saginaw, MI",191821,Metropolitan Statistical Area,Native American,2,2,0,No meaningful results,,,,765,27,792
40980,"Saginaw, MI",191821,Metropolitan Statistical Area,AAPI,17,15,2,No meaningful results,,,,765,27,792
25740,"Helena, MT",79722,Micropolitan Statistical Area,Black,4,3,1,No meaningful results,,,,629,26,655
25740,"Helena, MT",79722,Micropolitan Statistical Area,Latino,10,10,0,No meaningful results,,,,629,26,655
25740,"Helena, MT",79722,Micropolitan Statistical Area,Native American,8,7,1,No meaningful results,,,,629,26,655
25740,"Helena, MT",79722,Micropolitan Statistical Area,AAPI,2,2,0,No meaningful results,,,,629,26,655
12140,"Auburn, IN",42927,Micropolitan Statistical Area,Black,3,2,1,No meaningful results,,,,310,19,329
12140,"Auburn, IN",42927,Micropolitan Statistical Area,Latino,4,4,0,No meaningful results,,,,310,19,329
12140,"Auburn, IN",42927,Micropolitan Statistical Area,Native American,0,0,0,No meaningful results,,,,310,19,329
12140,"Auburn, IN",42927,Micropolitan Statistical Area,AAPI,1,1,0,No meaningful results,,,,310,19,329
33780,"Monroe, MI",149727,Metropolitan Statistical Area,Black,12,9,3,No meaningful results,,,,1052,38,1090
33780,"Monroe, MI",149727,Metropolitan Statistical Area,Latino,22,18,4,No meaningful results,,,,1052,38,1090
33780,"Monroe, MI",149727,Metropolitan Statistical Area,Native American,2,2,0,No meaningful results,,,,1052,38,1090
33780,"Monroe, MI",149727,Metropolitan Statistical Area,AAPI,10,9,1,No meaningful results,,,,1052,38,1090
24900,"Greenwood, MS",39292,Micropolitan Statistical Area,Black,10,5,5,No meaningful results,,,,26,2,28
24900,"Greenwood, MS",39292,Micropolitan Statistical Area,Latino,1,1,0,No meaningful results,,,,26,2,28
24900,"Greenwood, MS",39292,Micropolitan Statistical Area,Native American,0,0,0,No meaningful results,,,,26,2,28
24900,"Greenwood, MS",39292,Micropolitan Statistical Area,AAPI,2,2,0,No meaningful results,,,,26,2,28
21580,"Española, NM",39159,Micropolitan Statistical Area,Black,1,0,1,No meaningful results,,,,20,2,22
21580,"Española, NM",39159,Micropolitan Statistical Area,Latino,21,20,1,No meaningful results,,,,20,2,22
21580,"Española, NM",39159,Micropolitan Statistical Area,Native American,2,2,0,No meaningful results,,,,20,2,22
21580,"Española, NM",39159,Micropolitan Statistical Area,AAPI,2,2,0,No meaningful results,,,,20,2,22
13140,"Beaumont-Port Arthur, TX",395174,Metropolitan Statistical Area,Black,115,88,27,Not statistcially significant,1.759347384,1.8,18,1146,91,1237
13140,"Beaumont-Port Arthur, TX",395174,Metropolitan Statistical Area,Latino,199,183,16,Not statistcially significant,0.783095857,0.8,8,1146,91,1237
13140,"Beaumont-Port Arthur, TX",395174,Metropolitan Statistical Area,Native American,6,5,1,Not statistcially significant,4.484010815,4.5,45,1146,91,1237
13140,"Beaumont-Port Arthur, TX",395174,Metropolitan Statistical Area,AAPI,88,77,11,Not statistcially significant,1.058542226,1.1,11,1146,91,1237
24340,"Grand Rapids-Kentwood, MI",1062392,Metropolitan Statistical Area,Black,208,189,19,Regression equation needs to be tweaked,2.45189463,2.5,25,8862,313,9175
24340,"Grand Rapids-Kentwood, MI",1062392,Metropolitan Statistical Area,Latino,494,463,31,Regression equation needs to be tweaked,1.333469825,1.3,13,8862,313,9175
24340,"Grand Rapids-Kentwood, MI",1062392,Metropolitan Statistical Area,Native American,26,26,0,Regression equation needs to be tweaked,1.72E-08,0,0,8862,313,9175
24340,"Grand Rapids-Kentwood, MI",1062392,Metropolitan Statistical Area,AAPI,332,314,18,Regression equation needs to be tweaked,1.465317176,1.5,15,8862,313,9175
24140,"Goldsboro, NC",123603,Metropolitan Statistical Area,Black,58,49,9,No meaningful results,,,,317,23,340
24140,"Goldsboro, NC",123603,Metropolitan Statistical Area,Latino,30,25,5,No meaningful results,,,,317,23,340
24140,"Goldsboro, NC",123603,Metropolitan Statistical Area,Native American,0,0,0,No meaningful results,,,,317,23,340
24140,"Goldsboro, NC",123603,Metropolitan Statistical Area,AAPI,3,3,0,No meaningful results,,,,317,23,340
16540,"Chambersburg-Waynesboro, PA",154147,Metropolitan Statistical Area,Black,11,10,1,No meaningful results,,,,598,25,623
16540,"Chambersburg-Waynesboro, PA",154147,Metropolitan Statistical Area,Latino,27,25,2,No meaningful results,,,,598,25,623
16540,"Chambersburg-Waynesboro, PA",154147,Metropolitan Statistical Area,Native American,1,1,0,No meaningful results,,,,598,25,623
16540,"Chambersburg-Waynesboro, PA",154147,Metropolitan Statistical Area,AAPI,2,2,0,No meaningful results,,,,598,25,623
11420,"Angola, IN",34453,Micropolitan Statistical Area,Black,1,0,1,No meaningful results,,,,190,13,203
11420,"Angola, IN",34453,Micropolitan Statistical Area,Latino,4,4,0,No meaningful results,,,,190,13,203
11420,"Angola, IN",34453,Micropolitan Statistical Area,Native American,1,1,0,No meaningful results,,,,190,13,203
11420,"Angola, IN",34453,Micropolitan Statistical Area,AAPI,3,2,1,No meaningful results,,,,190,13,203
33420,"Mineral Wells, TX",28540,Micropolitan Statistical Area,Black,0,0,0,No meaningful results,,,,82,9,91
33420,"Mineral Wells, TX",28540,Micropolitan Statistical Area,Latino,16,12,4,No meaningful results,,,,82,9,91
33420,"Mineral Wells, TX",28540,Micropolitan Statistical Area,Native American,0,0,0,No meaningful results,,,,82,9,91
33420,"Mineral Wells, TX",28540,Micropolitan Statistical Area,AAPI,1,1,0,No meaningful results,,,,82,9,91
34300,"Mountain Home, ID",26743,Micropolitan Statistical Area,Black,2,2,0,No meaningful results,,,,107,5,112
34300,"Mountain Home, ID",26743,Micropolitan Statistical Area,Latino,16,15,1,No meaningful results,,,,107,5,112
34300,"Mountain Home, ID",26743,Micropolitan Statistical Area,Native American,1,1,0,No meaningful results,,,,107,5,112
34300,"Mountain Home, ID",26743,Micropolitan Statistical Area,AAPI,1,1,0,No meaningful results,,,,107,5,112
12300,"Augusta-Waterville, ME",121753,Micropolitan Statistical Area,Black,2,2,0,No meaningful results,,,,357,25,382
12300,"Augusta-Waterville, ME",121753,Micropolitan Statistical Area,Latino,4,4,0,No meaningful results,,,,357,25,382
12300,"Augusta-Waterville, ME",121753,Micropolitan Statistical Area,Native American,3,2,1,No meaningful results,,,,357,25,382
12300,"Augusta-Waterville, ME",121753,Micropolitan Statistical Area,AAPI,3,3,0,No meaningful results,,,,357,25,382
14780,"Brenham, TX",35163,Micropolitan Statistical Area,Black,2,2,0,No meaningful results,,,,138,8,146
14780,"Brenham, TX",35163,Micropolitan Statistical Area,Latino,9,8,1,No meaningful results,,,,138,8,146
14780,"Brenham, TX",35163,Micropolitan Statistical Area,Native American,1,1,0,No meaningful results,,,,138,8,146
14780,"Brenham, TX",35163,Micropolitan Statistical Area,AAPI,2,2,0,No meaningful results,,,,138,8,146
25460,"Harrison, AR",45143,Micropolitan Statistical Area,Black,0,0,0,No meaningful results,,,,151,13,164
25460,"Harrison, AR",45143,Micropolitan Statistical Area,Latino,0,0,0,No meaningful results,,,,151,13,164
25460,"Harrison, AR",45143,Micropolitan Statistical Area,Native American,2,2,0,No meaningful results,,,,151,13,164
25460,"Harrison, AR",45143,Micropolitan Statistical Area,AAPI,1,1,0,No meaningful results,,,,151,13,164
13940,"Blackfoot, ID",45839,Micropolitan Statistical Area,Black,0,0,0,No meaningful results,,,,261,15,276
13940,"Blackfoot, ID",45839,Micropolitan Statistical Area,Latino,20,16,4,No meaningful results,,,,261,15,276
13940,"Blackfoot, ID",45839,Micropolitan Statistical Area,Native American,0,0,0,No meaningful results,,,,261,15,276
13940,"Blackfoot, ID",45839,Micropolitan Statistical Area,AAPI,2,2,0,No meaningful results,,,,261,15,276
45500,"Texarkana, TX-AR",149292,Metropolitan Statistical Area,Black,37,21,16,No meaningful results,,,,378,23,401
45500,"Texarkana, TX-AR",149292,Metropolitan Statistical Area,Latino,13,13,0,No meaningful results,,,,378,23,401
45500,"Texarkana, TX-AR",149292,Metropolitan Statistical Area,Native American,4,4,0,No meaningful results,,,,378,23,401
45500,"Texarkana, TX-AR",149292,Metropolitan Statistical Area,AAPI,15,14,1,No meaningful results,,,,378,23,401
27620,"Jefferson City, MO",151273,Metropolitan Statistical Area,Black,17,16,1,No meaningful results,,,,778,22,800
27620,"Jefferson City, MO",151273,Metropolitan Statistical Area,Latino,11,10,1,No meaningful results,,,,778,22,800
27620,"Jefferson City, MO",151273,Metropolitan Statistical Area,Native American,5,4,1,No meaningful results,,,,778,22,800
27620,"Jefferson City, MO",151273,Metropolitan Statistical Area,AAPI,9,9,0,No meaningful results,,,,778,22,800
27220,"Jackson, WY-ID",34706,Micropolitan Statistical Area,Black,1,1,0,Regression equation needs to be tweaked,8.59E-07,0,0,218,26,244
27220,"Jackson, WY-ID",34706,Micropolitan Statistical Area,Latino,15,13,2,Regression equation needs to be tweaked,3.567734893,3.6,36,218,26,244
27220,"Jackson, WY-ID",34706,Micropolitan Statistical Area,Native American,0,0,0,Regression equation needs to be tweaked,935483.4174,935483.4,9354834,218,26,244
27220,"Jackson, WY-ID",34706,Micropolitan Statistical Area,AAPI,3,3,0,Regression equation needs to be tweaked,7.41E-24,0,0,218,26,244
26300,"Hot Springs, AR",98555,Metropolitan Statistical Area,Black,13,9,4,Regression equation needs to be tweaked,1.091224999,1.1,11,474,35,509
26300,"Hot Springs, AR",98555,Metropolitan Statistical Area,Latino,18,17,1,Regression equation needs to be tweaked,0.313782594,0.3,3,474,35,509
26300,"Hot Springs, AR",98555,Metropolitan Statistical Area,Native American,1,1,0,Regression equation needs to be tweaked,3.37E-08,0,0,474,35,509
26300,"Hot Springs, AR",98555,Metropolitan Statistical Area,AAPI,10,10,0,Regression equation needs to be tweaked,1.79E-08,0,0,474,35,509
10940,"Alma, MI",40916,Micropolitan Statistical Area,Black,0,0,0,No meaningful results,,,,143,15,158
10940,"Alma, MI",40916,Micropolitan Statistical Area,Latino,5,4,1,No meaningful results,,,,143,15,158
10940,"Alma, MI",40916,Micropolitan Statistical Area,Native American,1,1,0,No meaningful results,,,,143,15,158
10940,"Alma, MI",40916,Micropolitan Statistical Area,AAPI,0,0,0,No meaningful results,,,,143,15,158
37060,"Oxford, MS",53590,Micropolitan Statistical Area,Black,17,17,0,No meaningful results,,,,296,13,309
37060,"Oxford, MS",53590,Micropolitan Statistical Area,Latino,7,7,0,No meaningful results,,,,296,13,309
37060,"Oxford, MS",53590,Micropolitan Statistical Area,Native American,0,0,0,No meaningful results,,,,296,13,309
37060,"Oxford, MS",53590,Micropolitan Statistical Area,AAPI,10,10,0,No meaningful results,,,,296,13,309
25900,"Hilo, HI",199459,Micropolitan Statistical Area,Black,6,6,0,Regression equation needs to be tweaked,1.65E-08,0,0,559,45,604
25900,"Hilo, HI",199459,Micropolitan Statistical Area,Latino,51,45,6,Regression equation needs to be tweaked,2.38226356,2.4,24,559,45,604
25900,"Hilo, HI",199459,Micropolitan Statistical Area,Native American,7,7,0,Regression equation needs to be tweaked,2.62E-09,0,0,559,45,604
25900,"Hilo, HI",199459,Micropolitan Statistical Area,AAPI,278,242,36,Regression equation needs to be tweaked,2.097573875,2.1,21,559,45,604
40300,"Rochelle, IL",51025,Micropolitan Statistical Area,Black,3,3,0,No meaningful results,,,,153,15,168
40300,"Rochelle, IL",51025,Micropolitan Statistical Area,Latino,12,11,1,No meaningful results,,,,153,15,168
40300,"Rochelle, IL",51025,Micropolitan Statistical Area,Native American,0,0,0,No meaningful results,,,,153,15,168
40300,"Rochelle, IL",51025,Micropolitan Statistical Area,AAPI,0,0,0,No meaningful results,,,,153,15,168
45780,"Toledo, OH",644137,Metropolitan Statistical Area,Black,192,172,20,Regression equation needs to be tweaked,1.912260941,1.9,19,4120,166,4286
45780,"Toledo, OH",644137,Metropolitan Statistical Area,Latino,170,157,13,Regression equation needs to be tweaked,1.58869033,1.6,16,4120,166,4286
45780,"Toledo, OH",644137,Metropolitan Statistical Area,Native American,11,10,1,Regression equation needs to be tweaked,3.068226891,3.1,31,4120,166,4286
45780,"Toledo, OH",644137,Metropolitan Statistical Area,AAPI,104,100,4,Regression equation needs to be tweaked,1.400906336,1.4,14,4120,166,4286
10980,"Alpena, MI",28520,Micropolitan Statistical Area,Black,0,0,0,No meaningful results,,,,68,5,73
10980,"Alpena, MI",28520,Micropolitan Statistical Area,Latino,0,0,0,No meaningful results,,,,68,5,73
10980,"Alpena, MI",28520,Micropolitan Statistical Area,Native American,0,0,0,No meaningful results,,,,68,5,73
10980,"Alpena, MI",28520,Micropolitan Statistical Area,AAPI,0,0,0,No meaningful results,,,,68,5,73
46620,"Uvalde, TX",26920,Micropolitan Statistical Area,Black,0,0,0,No meaningful results,,,,33,3,36
46620,"Uvalde, TX",26920,Micropolitan Statistical Area,Latino,18,15,3,No meaningful results,,,,33,3,36
46620,"Uvalde, TX",26920,Micropolitan Statistical Area,Native American,1,1,0,No meaningful results,,,,33,3,36
46620,"Uvalde, TX",26920,Micropolitan Statistical Area,AAPI,2,2,0,No meaningful results,,,,33,3,36
17780,"College Station-Bryan, TX",258029,Metropolitan Statistical Area,Black,51,38,13,Not enough of applications,5.335462526,5.3,53,1089,49,1138
17780,"College Station-Bryan, TX",258029,Metropolitan Statistical Area,Latino,159,143,16,Not statistcially significant,1.362599114,1.4,14,1089,49,1138
17780,"College Station-Bryan, TX",258029,Metropolitan Statistical Area,Native American,8,7,1,Not statistcially significant,6.130781999,6.1,61,1089,49,1138
17780,"College Station-Bryan, TX",258029,Metropolitan Statistical Area,AAPI,80,75,5,Not statistcially significant,2.198517116,2.2,22,1089,49,1138
36830,"Othello, WA",19594,Micropolitan Statistical Area,Black,0,0,0,No meaningful results,,,,29,2,31
36830,"Othello, WA",19594,Micropolitan Statistical Area,Latino,35,32,3,No meaningful results,,,,29,2,31
36830,"Othello, WA",19594,Micropolitan Statistical Area,Native American,0,0,0,No meaningful results,,,,29,2,31
36830,"Othello, WA",19594,Micropolitan Statistical Area,AAPI,3,3,0,No meaningful results,,,,29,2,31
19460,"Decatur, AL",152271,Metropolitan Statistical Area,Black,33,30,3,No meaningful results,,,,670,37,707
19460,"Decatur, AL",152271,Metropolitan Statistical Area,Latino,26,23,3,No meaningful results,,,,670,37,707
19460,"Decatur, AL",152271,Metropolitan Statistical Area,Native American,6,6,0,No meaningful results,,,,670,37,707
19460,"Decatur, AL",152271,Metropolitan Statistical Area,AAPI,10,9,1,No meaningful results,,,,670,37,707
41760,"Sandpoint, ID",43611,Micropolitan Statistical Area,Black,1,1,0,No meaningful results,,,,405,33,438
41760,"Sandpoint, ID",43611,Micropolitan Statistical Area,Latino,8,7,1,No meaningful results,,,,405,33,438
41760,"Sandpoint, ID",43611,Micropolitan Statistical Area,Native American,6,4,2,No meaningful results,,,,405,33,438
41760,"Sandpoint, ID",43611,Micropolitan Statistical Area,AAPI,2,2,0,No meaningful results,,,,405,33,438
40180,"Riverton, WY",39812,Micropolitan Statistical Area,Black,0,0,0,No meaningful results,,,,96,10,106
40180,"Riverton, WY",39812,Micropolitan Statistical Area,Latino,4,4,0,No meaningful results,,,,96,10,106
40180,"Riverton, WY",39812,Micropolitan Statistical Area,Native American,2,1,1,No meaningful results,,,,96,10,106
40180,"Riverton, WY",39812,Micropolitan Statistical Area,AAPI,2,2,0,No meaningful results,,,,96,10,106
16220,"Casper, WY",80333,Metropolitan Statistical Area,Black,2,2,0,No meaningful results,,,,515,24,539
16220,"Casper, WY",80333,Metropolitan Statistical Area,Latino,19,17,2,No meaningful results,,,,515,24,539
16220,"Casper, WY",80333,Metropolitan Statistical Area,Native American,0,0,0,No meaningful results,,,,515,24,539
16220,"Casper, WY",80333,Metropolitan Statistical Area,AAPI,2,2,0,No meaningful results,,,,515,24,539
28340,"Kendallville, IN",47506,Micropolitan Statistical Area,Black,1,1,0,No meaningful results,,,,223,15,238
28340,"Kendallville, IN",47506,Micropolitan Statistical Area,Latino,24,22,2,No meaningful results,,,,223,15,238
28340,"Kendallville, IN",47506,Micropolitan Statistical Area,Native American,1,1,0,No meaningful results,,,,223,15,238
28340,"Kendallville, IN",47506,Micropolitan Statistical Area,AAPI,4,2,2,No meaningful results,,,,223,15,238
21820,"Fairbanks, AK",99072,Metropolitan Statistical Area,Black,5,5,0,No meaningful results,,,,231,14,245
21820,"Fairbanks, AK",99072,Metropolitan Statistical Area,Latino,18,16,2,No meaningful results,,,,231,14,245
21820,"Fairbanks, AK",99072,Metropolitan Statistical Area,Native American,16,16,0,No meaningful results,,,,231,14,245
21820,"Fairbanks, AK",99072,Metropolitan Statistical Area,AAPI,20,19,1,No meaningful results,,,,231,14,245
21780,"Evansville, IN-KY",314960,Metropolitan Statistical Area,Black,48,38,10,Not enough of applications,8.704337262,8.7,87,2032,65,2097
21780,"Evansville, IN-KY",314960,Metropolitan Statistical Area,Latino,35,32,3,Not statistcially significant,1.185814909,1.2,12,2032,65,2097
21780,"Evansville, IN-KY",314960,Metropolitan Statistical Area,Native American,4,3,1,Not enough of applications,12.33996623,12.3,123,2032,65,2097
21780,"Evansville, IN-KY",314960,Metropolitan Statistical Area,AAPI,50,49,1,Not statistcially significant,1.23512617,1.2,12,2032,65,2097
37580,"Paris, TX",49611,Micropolitan Statistical Area,Black,3,3,0,No meaningful results,,,,97,11,108
37580,"Paris, TX",49611,Micropolitan Statistical Area,Latino,7,7,0,No meaningful results,,,,97,11,108
37580,"Paris, TX",49611,Micropolitan Statistical Area,Native American,4,2,2,No meaningful results,,,,97,11,108
37580,"Paris, TX",49611,Micropolitan Statistical Area,AAPI,2,2,0,No meaningful results,,,,97,11,108
34260,"Mountain Home, AR",41427,Micropolitan Statistical Area,Black,0,0,0,No meaningful results,,,,204,13,217
34260,"Mountain Home, AR",41427,Micropolitan Statistical Area,Latino,4,3,1,No meaningful results,,,,204,13,217
34260,"Mountain Home, AR",41427,Micropolitan Statistical Area,Native American,0,0,0,No meaningful results,,,,204,13,217
34260,"Mountain Home, AR",41427,Micropolitan Statistical Area,AAPI,2,2,0,No meaningful results,,,,204,13,217
23460,"Gadsden, AL",102748,Metropolitan Statistical Area,Black,17,13,4,No meaningful results,,,,284,18,302
23460,"Gadsden, AL",102748,Metropolitan Statistical Area,Latino,9,8,1,No meaningful results,,,,284,18,302
23460,"Gadsden, AL",102748,Metropolitan Statistical Area,Native American,1,1,0,No meaningful results,,,,284,18,302
23460,"Gadsden, AL",102748,Metropolitan Statistical Area,AAPI,7,7,0,No meaningful results,,,,284,18,302
45180,"Talladega-Sylacauga, AL",80387,Micropolitan Statistical Area,Black,15,14,1,No meaningful results,,,,154,11,165
45180,"Talladega-Sylacauga, AL",80387,Micropolitan Statistical Area,Latino,3,2,1,No meaningful results,,,,154,11,165
45180,"Talladega-Sylacauga, AL",80387,Micropolitan Statistical Area,Native American,0,0,0,No meaningful results,,,,154,11,165
45180,"Talladega-Sylacauga, AL",80387,Micropolitan Statistical Area,AAPI,3,2,1,No meaningful results,,,,154,11,165
46380,"Ukiah, CA",87224,Micropolitan Statistical Area,Black,2,2,0,No meaningful results,,,,197,24,221
46380,"Ukiah, CA",87224,Micropolitan Statistical Area,Latino,64,55,9,No meaningful results,,,,197,24,221
46380,"Ukiah, CA",87224,Micropolitan Statistical Area,Native American,7,5,2,No meaningful results,,,,197,24,221
46380,"Ukiah, CA",87224,Micropolitan Statistical Area,AAPI,6,6,0,No meaningful results,,,,197,24,221
49660,"Youngstown-Warren-Boardman, OH-PA",541846,Metropolitan Statistical Area,Black,61,52,9,Not statistcially significant,0.925125248,0.9,9,2209,153,2362
49660,"Youngstown-Warren-Boardman, OH-PA",541846,Metropolitan Statistical Area,Latino,57,46,11,Not enough of applications,3.110558665,3.1,31,2209,153,2362
49660,"Youngstown-Warren-Boardman, OH-PA",541846,Metropolitan Statistical Area,Native American,3,1,2,Not statistcially significant,3.038116929,3,30,2209,153,2362
49660,"Youngstown-Warren-Boardman, OH-PA",541846,Metropolitan Statistical Area,AAPI,25,22,3,Not statistcially significant,1.645583729,1.6,16,2209,153,2362
49700,"Yuba City, CA",172469,Metropolitan Statistical Area,Black,23,18,5,Not enough of applications,4.766067965,4.8,48,526,38,564
49700,"Yuba City, CA",172469,Metropolitan Statistical Area,Latino,186,166,20,Not statistcially significant,1.455861869,1.5,15,526,38,564
49700,"Yuba City, CA",172469,Metropolitan Statistical Area,Native American,5,4,1,Not statistcially significant,4.613260235,4.6,46,526,38,564
49700,"Yuba City, CA",172469,Metropolitan Statistical Area,AAPI,182,160,22,Not statistcially significant,1.514254364,1.5,15,526,38,564
40100,"Rio Grande City-Roma, TX",64078,Micropolitan Statistical Area,Black,0,0,0,No meaningful results,,,,1,0,1
40100,"Rio Grande City-Roma, TX",64078,Micropolitan Statistical Area,Latino,43,36,7,No meaningful results,,,,1,0,1
40100,"Rio Grande City-Roma, TX",64078,Micropolitan Statistical Area,Native American,0,0,0,No meaningful results,,,,1,0,1
40100,"Rio Grande City-Roma, TX",64078,Micropolitan Statistical Area,AAPI,0,0,0,No meaningful results,,,,1,0,1
48020,"Watertown-Fort Atkinson, WI",84701,Micropolitan Statistical Area,Black,1,1,0,No meaningful results,,,,569,32,601
48020,"Watertown-Fort Atkinson, WI",84701,Micropolitan Statistical Area,Latino,21,20,1,No meaningful results,,,,569,32,601
48020,"Watertown-Fort Atkinson, WI",84701,Micropolitan Statistical Area,Native American,0,0,0,No meaningful results,,,,569,32,601
48020,"Watertown-Fort Atkinson, WI",84701,Micropolitan Statistical Area,AAPI,3,3,0,No meaningful results,,,,569,32,601
44500,"Stephenville, TX",41841,Micropolitan Statistical Area,Black,1,1,0,No meaningful results,,,,147,8,155
44500,"Stephenville, TX",41841,Micropolitan Statistical Area,Latino,9,9,0,No meaningful results,,,,147,8,155
44500,"Stephenville, TX",41841,Micropolitan Statistical Area,Native American,2,1,1,No meaningful results,,,,147,8,155
44500,"Stephenville, TX",41841,Micropolitan Statistical Area,AAPI,4,3,1,No meaningful results,,,,147,8,155
27380,"Jacksonville, TX",52118,Micropolitan Statistical Area,Black,5,4,1,No meaningful results,,,,146,32,178
27380,"Jacksonville, TX",52118,Micropolitan Statistical Area,Latino,38,26,12,No meaningful results,,,,146,32,178
27380,"Jacksonville, TX",52118,Micropolitan Statistical Area,Native American,0,0,0,No meaningful results,,,,146,32,178
27380,"Jacksonville, TX",52118,Micropolitan Statistical Area,AAPI,0,0,0,No meaningful results,,,,146,32,178
21140,"Elkhart-Goshen, IN",204558,Metropolitan Statistical Area,Black,18,18,0,No meaningful results,,,,1242,50,1292
21140,"Elkhart-Goshen, IN",204558,Metropolitan Statistical Area,Latino,229,209,20,No meaningful results,,,,1242,50,1292
21140,"Elkhart-Goshen, IN",204558,Metropolitan Statistical Area,Native American,3,3,0,No meaningful results,,,,1242,50,1292
21140,"Elkhart-Goshen, IN",204558,Metropolitan Statistical Area,AAPI,18,18,0,No meaningful results,,,,1242,50,1292
47660,"Warrensburg, MO",53682,Micropolitan Statistical Area,Black,1,1,0,No meaningful results,,,,161,11,172
47660,"Warrensburg, MO",53682,Micropolitan Statistical Area,Latino,1,1,0,No meaningful results,,,,161,11,172
47660,"Warrensburg, MO",53682,Micropolitan Statistical Area,Native American,1,0,1,No meaningful results,,,,161,11,172
47660,"Warrensburg, MO",53682,Micropolitan Statistical Area,AAPI,5,5,0,No meaningful results,,,,161,11,172
13660,"Big Rapids, MI",43251,Micropolitan Statistical Area,Black,4,2,2,No meaningful results,,,,210,14,224
13660,"Big Rapids, MI",43251,Micropolitan Statistical Area,Latino,1,1,0,No meaningful results,,,,210,14,224
13660,"Big Rapids, MI",43251,Micropolitan Statistical Area,Native American,1,0,1,No meaningful results,,,,210,14,224
13660,"Big Rapids, MI",43251,Micropolitan Statistical Area,AAPI,3,3,0,No meaningful results,,,,210,14,224
24980,"Grenada, MS",21088,Micropolitan Statistical Area,Black,7,4,3,No meaningful results,,,,37,0,37
24980,"Grenada, MS",21088,Micropolitan Statistical Area,Latino,1,1,0,No meaningful results,,,,37,0,37
24980,"Grenada, MS",21088,Micropolitan Statistical Area,Native American,0,0,0,No meaningful results,,,,37,0,37
24980,"Grenada, MS",21088,Micropolitan Statistical Area,AAPI,0,0,0,No meaningful results,,,,37,0,37
39780,"Red Bluff, CA",63912,Micropolitan Statistical Area,Black,1,1,0,No meaningful results,,,,245,6,251
39780,"Red Bluff, CA",63912,Micropolitan Statistical Area,Latino,43,37,6,No meaningful results,,,,245,6,251
39780,"Red Bluff, CA",63912,Micropolitan Statistical Area,Native American,5,5,0,No meaningful results,,,,245,6,251
39780,"Red Bluff, CA",63912,Micropolitan Statistical Area,AAPI,9,7,2,No meaningful results,,,,245,6,251
37260,"Palatka, FL",73252,Micropolitan Statistical Area,Black,8,4,4,No meaningful results,,,,170,24,194
37260,"Palatka, FL",73252,Micropolitan Statistical Area,Latino,5,4,1,No meaningful results,,,,170,24,194
37260,"Palatka, FL",73252,Micropolitan Statistical Area,Native American,0,0,0,No meaningful results,,,,170,24,194
37260,"Palatka, FL",73252,Micropolitan Statistical Area,AAPI,4,4,0,No meaningful results,,,,170,24,194
40580,"Rocky Mount, NC",146678,Metropolitan Statistical Area,Black,137,113,24,Regression equation needs to be tweaked,10.39179658,10.4,104,377,14,391
40580,"Rocky Mount, NC",146678,Metropolitan Statistical Area,Latino,28,23,5,Regression equation needs to be tweaked,5.314790626,5.3,53,377,14,391
40580,"Rocky Mount, NC",146678,Metropolitan Statistical Area,Native American,7,3,4,Regression equation needs to be tweaked,97.95132694,98,980,377,14,391
40580,"Rocky Mount, NC",146678,Metropolitan Statistical Area,AAPI,9,7,2,Regression equation needs to be tweaked,9.090861219,9.1,91,377,14,391
23900,"Gettysburg, PA",102470,Metropolitan Statistical Area,Black,4,3,1,No meaningful results,,,,499,29,528
23900,"Gettysburg, PA",102470,Metropolitan Statistical Area,Latino,20,17,3,No meaningful results,,,,499,29,528
23900,"Gettysburg, PA",102470,Metropolitan Statistical Area,Native American,0,0,0,No meaningful results,,,,499,29,528
23900,"Gettysburg, PA",102470,Metropolitan Statistical Area,AAPI,3,3,0,No meaningful results,,,,499,29,528
15420,"Burley, ID",44395,Micropolitan Statistical Area,Black,0,0,0,No meaningful results,,,,224,22,246
15420,"Burley, ID",44395,Micropolitan Statistical Area,Latino,70,67,3,No meaningful results,,,,224,22,246
15420,"Burley, ID",44395,Micropolitan Statistical Area,Native American,2,2,0,No meaningful results,,,,224,22,246
15420,"Burley, ID",44395,Micropolitan Statistical Area,AAPI,0,0,0,No meaningful results,,,,224,22,246
27860,"Jonesboro, AR",131241,Metropolitan Statistical Area,Black,18,13,5,No meaningful results,,,,578,28,606
27860,"Jonesboro, AR",131241,Metropolitan Statistical Area,Latino,31,25,6,No meaningful results,,,,578,28,606
27860,"Jonesboro, AR",131241,Metropolitan Statistical Area,Native American,3,2,1,No meaningful results,,,,578,28,606
27860,"Jonesboro, AR",131241,Metropolitan Statistical Area,AAPI,30,28,2,No meaningful results,,,,578,28,606
39220,"Price, UT",20308,Micropolitan Statistical Area,Black,0,0,0,No meaningful results,,,,78,4,82
39220,"Price, UT",20308,Micropolitan Statistical Area,Latino,6,4,2,No meaningful results,,,,78,4,82
39220,"Price, UT",20308,Micropolitan Statistical Area,Native American,0,0,0,No meaningful results,,,,78,4,82
39220,"Price, UT",20308,Micropolitan Statistical Area,AAPI,2,2,0,No meaningful results,,,,78,4,82
38540,"Pocatello, ID",93436,Metropolitan Statistical Area,Black,5,4,1,No meaningful results,,,,743,19,762
38540,"Pocatello, ID",93436,Metropolitan Statistical Area,Latino,49,46,3,No meaningful results,,,,743,19,762
38540,"Pocatello, ID",93436,Metropolitan Statistical Area,Native American,6,6,0,No meaningful results,,,,743,19,762
38540,"Pocatello, ID",93436,Metropolitan Statistical Area,AAPI,17,16,1,No meaningful results,,,,743,19,762
44180,"Springfield, MO",462434,Metropolitan Statistical Area,Black,26,22,4,Regression equation needs to be tweaked,1.58347822,1.6,16,3205,156,3361
44180,"Springfield, MO",462434,Metropolitan Statistical Area,Latino,72,67,5,Regression equation needs to be tweaked,1.082546438,1.1,11,3205,156,3361
44180,"Springfield, MO",462434,Metropolitan Statistical Area,Native American,17,15,2,Regression equation needs to be tweaked,3.924286731,3.9,39,3205,156,3361
44180,"Springfield, MO",462434,Metropolitan Statistical Area,AAPI,76,68,8,Regression equation needs to be tweaked,2.761899319,2.8,28,3205,156,3361
21740,"Evanston, WY",20479,Micropolitan Statistical Area,Black,0,0,0,No meaningful results,,,,78,4,82
21740,"Evanston, WY",20479,Micropolitan Statistical Area,Latino,6,6,0,No meaningful results,,,,78,4,82
21740,"Evanston, WY",20479,Micropolitan Statistical Area,Native American,0,0,0,No meaningful results,,,,78,4,82
21740,"Evanston, WY",20479,Micropolitan Statistical Area,AAPI,1,1,0,No meaningful results,,,,78,4,82
35220,"New Castle, IN",48255,Micropolitan Statistical Area,Black,2,2,0,No meaningful results,,,,190,21,211
35220,"New Castle, IN",48255,Micropolitan Statistical Area,Latino,1,1,0,No meaningful results,,,,190,21,211
35220,"New Castle, IN",48255,Micropolitan Statistical Area,Native American,0,0,0,No meaningful results,,,,190,21,211
35220,"New Castle, IN",48255,Micropolitan Statistical Area,AAPI,2,2,0,No meaningful results,,,,190,21,211
28020,"Kalamazoo-Portage, MI",262745,Metropolitan Statistical Area,Black,83,75,8,No meaningful results,,,,2061,49,2110
28020,"Kalamazoo-Portage, MI",262745,Metropolitan Statistical Area,Latino,73,69,4,No meaningful results,,,,2061,49,2110
28020,"Kalamazoo-Portage, MI",262745,Metropolitan Statistical Area,Native American,10,10,0,No meaningful results,,,,2061,49,2110
28020,"Kalamazoo-Portage, MI",262745,Metropolitan Statistical Area,AAPI,67,64,3,No meaningful results,,,,2061,49,2110
25200,"Hailey, ID",23421,Micropolitan Statistical Area,Black,0,0,0,No meaningful results,,,,216,21,237
25200,"Hailey, ID",23421,Micropolitan Statistical Area,Latino,13,13,0,No meaningful results,,,,216,21,237
25200,"Hailey, ID",23421,Micropolitan Statistical Area,Native American,2,2,0,No meaningful results,,,,216,21,237
25200,"Hailey, ID",23421,Micropolitan Statistical Area,AAPI,2,1,1,No meaningful results,,,,216,21,237
17340,"Clearlake, CA",64195,Micropolitan Statistical Area,Black,1,1,0,No meaningful results,,,,174,15,189
17340,"Clearlake, CA",64195,Micropolitan Statistical Area,Latino,42,37,5,No meaningful results,,,,174,15,189
17340,"Clearlake, CA",64195,Micropolitan Statistical Area,Native American,3,3,0,No meaningful results,,,,174,15,189
17340,"Clearlake, CA",64195,Micropolitan Statistical Area,AAPI,8,6,2,No meaningful results,,,,174,15,189
37900,"Peoria, IL",406883,Metropolitan Statistical Area,Black,79,68,11,Regression equation needs to be tweaked,2.432001187,2.4,24,2545,117,2662
37900,"Peoria, IL",406883,Metropolitan Statistical Area,Latino,66,61,5,Regression equation needs to be tweaked,0.97746874,1,10,2545,117,2662
37900,"Peoria, IL",406883,Metropolitan Statistical Area,Native American,12,12,0,Regression equation needs to be tweaked,3.58E-11,0,0,2545,117,2662
37900,"Peoria, IL",406883,Metropolitan Statistical Area,AAPI,87,80,7,Regression equation needs to be tweaked,4.165733822,4.2,42,2545,117,2662
29200,"Lafayette-West Lafayette, IN",228541,Metropolitan Statistical Area,Black,40,37,3,Regression equation needs to be tweaked,1.462099882,1.5,15,1511,54,1565
29200,"Lafayette-West Lafayette, IN",228541,Metropolitan Statistical Area,Latino,109,101,8,Regression equation needs to be tweaked,2.338004624,2.3,23,1511,54,1565
29200,"Lafayette-West Lafayette, IN",228541,Metropolitan Statistical Area,Native American,4,3,1,Regression equation needs to be tweaked,24.32655036,24.3,243,1511,54,1565
29200,"Lafayette-West Lafayette, IN",228541,Metropolitan Statistical Area,AAPI,85,82,3,Regression equation needs to be tweaked,2.12864478,2.1,21,1511,54,1565
22100,"Farmington, MO",66643,Micropolitan Statistical Area,Black,2,2,0,No meaningful results,,,,256,22,278
22100,"Farmington, MO",66643,Micropolitan Statistical Area,Latino,2,2,0,No meaningful results,,,,256,22,278
22100,"Farmington, MO",66643,Micropolitan Statistical Area,Native American,1,1,0,No meaningful results,,,,256,22,278
22100,"Farmington, MO",66643,Micropolitan Statistical Area,AAPI,2,2,0,No meaningful results,,,,256,22,278
14010,"Bloomington, IL",172578,Metropolitan Statistical Area,Black,49,44,5,Regression equation needs to be tweaked,3.158577462,3.2,32,1265,43,1308
14010,"Bloomington, IL",172578,Metropolitan Statistical Area,Latino,55,49,6,Regression equation needs to be tweaked,3.627451491,3.6,36,1265,43,1308
14010,"Bloomington, IL",172578,Metropolitan Statistical Area,Native American,3,3,0,Regression equation needs to be tweaked,2.26E-05,0,0,1265,43,1308
14010,"Bloomington, IL",172578,Metropolitan Statistical Area,AAPI,108,107,1,Regression equation needs to be tweaked,0.497940847,0.5,5,1265,43,1308
19500,"Decatur, IL",105528,Metropolitan Statistical Area,Black,28,26,2,No meaningful results,,,,513,28,541
19500,"Decatur, IL",105528,Metropolitan Statistical Area,Latino,10,8,2,No meaningful results,,,,513,28,541
19500,"Decatur, IL",105528,Metropolitan Statistical Area,Native American,0,0,0,No meaningful results,,,,513,28,541
19500,"Decatur, IL",105528,Metropolitan Statistical Area,AAPI,7,7,0,No meaningful results,,,,513,28,541
30660,"Lincoln, IL",29003,Micropolitan Statistical Area,Black,2,2,0,No meaningful results,,,,95,4,99
30660,"Lincoln, IL",29003,Micropolitan Statistical Area,Latino,1,1,0,No meaningful results,,,,95,4,99
30660,"Lincoln, IL",29003,Micropolitan Statistical Area,Native American,0,0,0,No meaningful results,,,,95,4,99
30660,"Lincoln, IL",29003,Micropolitan Statistical Area,AAPI,1,1,0,No meaningful results,,,,95,4,99
36837,"Ottawa, IL",148580,Micropolitan Statistical Area,Black,2,2,0,No meaningful results,,,,429,24,453
36837,"Ottawa, IL",148580,Micropolitan Statistical Area,Latino,36,31,5,No meaningful results,,,,429,24,453
36837,"Ottawa, IL",148580,Micropolitan Statistical Area,Native American,2,1,1,No meaningful results,,,,429,24,453
36837,"Ottawa, IL",148580,Micropolitan Statistical Area,AAPI,5,5,0,No meaningful results,,,,429,24,453
30780,"Little Rock-North Little Rock-Conway, AR",737015,Metropolitan Statistical Area,Black,439,373,66,No meaningful results,,,,3742,145,3887
30780,"Little Rock-North Little Rock-Conway, AR",737015,Metropolitan Statistical Area,Latino,128,111,17,No meaningful results,,,,3742,145,3887
30780,"Little Rock-North Little Rock-Conway, AR",737015,Metropolitan Statistical Area,Native American,15,13,2,No meaningful results,,,,3742,145,3887
30780,"Little Rock-North Little Rock-Conway, AR",737015,Metropolitan Statistical Area,AAPI,157,146,11,No meaningful results,,,,3742,145,3887
44420,"Staunton, VA",121651,Metropolitan Statistical Area,Black,24,19,5,No meaningful results,,,,751,39,790
44420,"Staunton, VA",121651,Metropolitan Statistical Area,Latino,49,42,7,No meaningful results,,,,751,39,790
44420,"Staunton, VA",121651,Metropolitan Statistical Area,Native American,2,2,0,No meaningful results,,,,751,39,790
44420,"Staunton, VA",121651,Metropolitan Statistical Area,AAPI,14,12,2,No meaningful results,,,,751,39,790
18020,"Columbus, IN",82481,Metropolitan Statistical Area,Black,12,9,3,No meaningful results,,,,650,25,675
18020,"Columbus, IN",82481,Metropolitan Statistical Area,Latino,62,60,2,No meaningful results,,,,650,25,675
18020,"Columbus, IN",82481,Metropolitan Statistical Area,Native American,2,2,0,No meaningful results,,,,650,25,675
18020,"Columbus, IN",82481,Metropolitan Statistical Area,AAPI,86,81,5,No meaningful results,,,,650,25,675
45380,"Taylorville, IL",32931,Micropolitan Statistical Area,Black,0,0,0,No meaningful results,,,,76,8,84
45380,"Taylorville, IL",32931,Micropolitan Statistical Area,Latino,0,0,0,No meaningful results,,,,76,8,84
45380,"Taylorville, IL",32931,Micropolitan Statistical Area,Native American,0,0,0,No meaningful results,,,,76,8,84
45380,"Taylorville, IL",32931,Micropolitan Statistical Area,AAPI,0,0,0,No meaningful results,,,,76,8,84
16060,"Carbondale-Marion, IL",137573,Metropolitan Statistical Area,Black,9,8,1,Regression equation needs to be tweaked,7.903558653,7.9,79,262,12,274
16060,"Carbondale-Marion, IL",137573,Metropolitan Statistical Area,Latino,10,8,2,Regression equation needs to be tweaked,26.25370563,26.3,263,262,12,274
16060,"Carbondale-Marion, IL",137573,Metropolitan Statistical Area,Native American,3,2,1,Regression equation needs to be tweaked,2.969804071,3,30,262,12,274
16060,"Carbondale-Marion, IL",137573,Metropolitan Statistical Area,AAPI,10,10,0,Regression equation needs to be tweaked,7.97E-07,0,0,262,12,274
17860,"Columbia, MO",205369,Metropolitan Statistical Area,Black,34,32,2,No meaningful results,,,,1306,35,1341
17860,"Columbia, MO",205369,Metropolitan Statistical Area,Latino,41,40,1,No meaningful results,,,,1306,35,1341
17860,"Columbia, MO",205369,Metropolitan Statistical Area,Native American,7,6,1,No meaningful results,,,,1306,35,1341
17860,"Columbia, MO",205369,Metropolitan Statistical Area,AAPI,65,62,3,No meaningful results,,,,1306,35,1341
27900,"Joplin, MO",178100,Metropolitan Statistical Area,Black,11,11,0,No meaningful results,,,,855,42,897
27900,"Joplin, MO",178100,Metropolitan Statistical Area,Latino,41,36,5,No meaningful results,,,,855,42,897
27900,"Joplin, MO",178100,Metropolitan Statistical Area,Native American,16,15,1,No meaningful results,,,,855,42,897
27900,"Joplin, MO",178100,Metropolitan Statistical Area,AAPI,11,11,0,No meaningful results,,,,855,42,897
31380,"Macomb, IL",30479,Micropolitan Statistical Area,Black,1,1,0,No meaningful results,,,,77,0,77
31380,"Macomb, IL",30479,Micropolitan Statistical Area,Latino,2,2,0,No meaningful results,,,,77,0,77
31380,"Macomb, IL",30479,Micropolitan Statistical Area,Native American,0,0,0,No meaningful results,,,,77,0,77
31380,"Macomb, IL",30479,Micropolitan Statistical Area,AAPI,1,1,0,No meaningful results,,,,77,0,77
40220,"Roanoke, VA",313009,Metropolitan Statistical Area,Black,73,65,8,No meaningful results,,,,1833,77,1910
40220,"Roanoke, VA",313009,Metropolitan Statistical Area,Latino,70,64,6,No meaningful results,,,,1833,77,1910
40220,"Roanoke, VA",313009,Metropolitan Statistical Area,Native American,8,6,2,No meaningful results,,,,1833,77,1910
40220,"Roanoke, VA",313009,Metropolitan Statistical Area,AAPI,55,53,2,No meaningful results,,,,1833,77,1910
47020,"Victoria, TX",99674,Metropolitan Statistical Area,Black,10,10,0,No meaningful results,,,,260,20,280
47020,"Victoria, TX",99674,Metropolitan Statistical Area,Latino,102,96,6,No meaningful results,,,,260,20,280
47020,"Victoria, TX",99674,Metropolitan Statistical Area,Native American,2,1,1,No meaningful results,,,,260,20,280
47020,"Victoria, TX",99674,Metropolitan Statistical Area,AAPI,13,11,2,No meaningful results,,,,260,20,280
27300,"Jacksonville, IL",39252,Micropolitan Statistical Area,Black,0,0,0,No meaningful results,,,,169,17,186
27300,"Jacksonville, IL",39252,Micropolitan Statistical Area,Latino,1,1,0,No meaningful results,,,,169,17,186
27300,"Jacksonville, IL",39252,Micropolitan Statistical Area,Native American,0,0,0,No meaningful results,,,,169,17,186
27300,"Jacksonville, IL",39252,Micropolitan Statistical Area,AAPI,2,2,0,No meaningful results,,,,169,17,186
10660,"Albert Lea, MN",30463,Micropolitan Statistical Area,Black,0,0,0,No meaningful results,,,,90,11,101
10660,"Albert Lea, MN",30463,Micropolitan Statistical Area,Latino,15,14,1,No meaningful results,,,,90,11,101
10660,"Albert Lea, MN",30463,Micropolitan Statistical Area,Native American,0,0,0,No meaningful results,,,,90,11,101
10660,"Albert Lea, MN",30463,Micropolitan Statistical Area,AAPI,9,8,1,No meaningful results,,,,90,11,101
37140,"Paducah, KY-IL",96754,Micropolitan Statistical Area,Black,6,5,1,No meaningful results,,,,237,22,259
37140,"Paducah, KY-IL",96754,Micropolitan Statistical Area,Latino,10,9,1,No meaningful results,,,,237,22,259
37140,"Paducah, KY-IL",96754,Micropolitan Statistical Area,Native American,0,0,0,No meaningful results,,,,237,22,259
37140,"Paducah, KY-IL",96754,Micropolitan Statistical Area,AAPI,0,0,0,No meaningful results,,,,237,22,259
13220,"Beckley, WV",118828,Metropolitan Statistical Area,Black,7,7,0,No meaningful results,,,,243,28,271
13220,"Beckley, WV",118828,Metropolitan Statistical Area,Latino,5,4,1,No meaningful results,,,,243,28,271
13220,"Beckley, WV",118828,Metropolitan Statistical Area,Native American,1,1,0,No meaningful results,,,,243,28,271
13220,"Beckley, WV",118828,Metropolitan Statistical Area,AAPI,6,4,2,No meaningful results,,,,243,28,271
12900,"Batesville, AR",54566,Micropolitan Statistical Area,Black,0,0,0,No meaningful results,,,,168,16,184
12900,"Batesville, AR",54566,Micropolitan Statistical Area,Latino,3,3,0,No meaningful results,,,,168,16,184
12900,"Batesville, AR",54566,Micropolitan Statistical Area,Native American,1,1,0,No meaningful results,,,,168,16,184
12900,"Batesville, AR",54566,Micropolitan Statistical Area,AAPI,1,1,0,No meaningful results,,,,168,16,184
40780,"Russellville, AR",85225,Micropolitan Statistical Area,Black,3,3,0,No meaningful results,,,,261,17,278
40780,"Russellville, AR",85225,Micropolitan Statistical Area,Latino,35,35,0,No meaningful results,,,,261,17,278
40780,"Russellville, AR",85225,Micropolitan Statistical Area,Native American,0,0,0,No meaningful results,,,,261,17,278
40780,"Russellville, AR",85225,Micropolitan Statistical Area,AAPI,5,4,1,No meaningful results,,,,261,17,278
23660,"Galesburg, IL",50508,Micropolitan Statistical Area,Black,10,10,0,No meaningful results,,,,234,14,248
23660,"Galesburg, IL",50508,Micropolitan Statistical Area,Latino,17,16,1,No meaningful results,,,,234,14,248
23660,"Galesburg, IL",50508,Micropolitan Statistical Area,Native American,0,0,0,No meaningful results,,,,234,14,248
23660,"Galesburg, IL",50508,Micropolitan Statistical Area,AAPI,2,2,0,No meaningful results,,,,234,14,248
40380,"Rochester, NY",1072877,Metropolitan Statistical Area,Black,257,230,27,No meaningful results,,,,5360,141,5501
40380,"Rochester, NY",1072877,Metropolitan Statistical Area,Latino,282,258,24,No meaningful results,,,,5360,141,5501
40380,"Rochester, NY",1072877,Metropolitan Statistical Area,Native American,11,11,0,No meaningful results,,,,5360,141,5501
40380,"Rochester, NY",1072877,Metropolitan Statistical Area,AAPI,287,269,18,No meaningful results,,,,5360,141,5501
37460,"Panama City, FL",182161,Metropolitan Statistical Area,Black,38,33,5,Regression equation needs to be tweaked,1.042343377,1,10,939,113,1052
37460,"Panama City, FL",182161,Metropolitan Statistical Area,Latino,65,54,11,Regression equation needs to be tweaked,1.881393849,1.9,19,939,113,1052
37460,"Panama City, FL",182161,Metropolitan Statistical Area,Native American,2,2,0,Regression equation needs to be tweaked,5.53E-06,0,0,939,113,1052
37460,"Panama City, FL",182161,Metropolitan Statistical Area,AAPI,54,48,6,Regression equation needs to be tweaked,0.861125366,0.9,9,939,113,1052
22220,"Fayetteville-Springdale-Rogers, AR",514259,Metropolitan Statistical Area,Black,77,67,10,Regression equation needs to be tweaked,3.085846115,3.1,31,3848,173,4021
22220,"Fayetteville-Springdale-Rogers, AR",514259,Metropolitan Statistical Area,Latino,523,479,44,Regression equation needs to be tweaked,1.743310742,1.7,17,3848,173,4021
22220,"Fayetteville-Springdale-Rogers, AR",514259,Metropolitan Statistical Area,Native American,49,46,3,Regression equation needs to be tweaked,1.627154048,1.6,16,3848,173,4021
22220,"Fayetteville-Springdale-Rogers, AR",514259,Metropolitan Statistical Area,AAPI,318,297,21,Regression equation needs to be tweaked,2.787117113,2.8,28,3848,173,4021
25300,"Hannibal, MO",38842,Micropolitan Statistical Area,Black,2,2,0,No meaningful results,,,,79,6,85
25300,"Hannibal, MO",38842,Micropolitan Statistical Area,Latino,1,0,1,No meaningful results,,,,79,6,85
25300,"Hannibal, MO",38842,Micropolitan Statistical Area,Native American,0,0,0,No meaningful results,,,,79,6,85
25300,"Hannibal, MO",38842,Micropolitan Statistical Area,AAPI,2,2,0,No meaningful results,,,,79,6,85
44580,"Sterling, IL",56016,Micropolitan Statistical Area,Black,0,0,0,No meaningful results,,,,113,8,121
44580,"Sterling, IL",56016,Micropolitan Statistical Area,Latino,7,7,0,No meaningful results,,,,113,8,121
44580,"Sterling, IL",56016,Micropolitan Statistical Area,Native American,1,1,0,No meaningful results,,,,113,8,121
44580,"Sterling, IL",56016,Micropolitan Statistical Area,AAPI,0,0,0,No meaningful results,,,,113,8,121
46220,"Tuscaloosa, AL",250681,Metropolitan Statistical Area,Black,268,225,43,No meaningful results,,,,940,31,971
46220,"Tuscaloosa, AL",250681,Metropolitan Statistical Area,Latino,33,28,5,No meaningful results,,,,940,31,971
46220,"Tuscaloosa, AL",250681,Metropolitan Statistical Area,Native American,1,1,0,No meaningful results,,,,940,31,971
46220,"Tuscaloosa, AL",250681,Metropolitan Statistical Area,AAPI,23,22,1,No meaningful results,,,,940,31,971
34420,"Mount Pleasant, TX",45518,Micropolitan Statistical Area,Black,2,1,1,No meaningful results,,,,85,6,91
34420,"Mount Pleasant, TX",45518,Micropolitan Statistical Area,Latino,39,33,6,No meaningful results,,,,85,6,91
34420,"Mount Pleasant, TX",45518,Micropolitan Statistical Area,Native American,0,0,0,No meaningful results,,,,85,6,91
34420,"Mount Pleasant, TX",45518,Micropolitan Statistical Area,AAPI,1,1,0,No meaningful results,,,,85,6,91
22020,"Fargo, ND-MN",240421,Metropolitan Statistical Area,Black,25,22,3,No meaningful results,,,,2095,43,2138
22020,"Fargo, ND-MN",240421,Metropolitan Statistical Area,Latino,24,23,1,No meaningful results,,,,2095,43,2138
22020,"Fargo, ND-MN",240421,Metropolitan Statistical Area,Native American,17,13,4,No meaningful results,,,,2095,43,2138
22020,"Fargo, ND-MN",240421,Metropolitan Statistical Area,AAPI,59,55,4,No meaningful results,,,,2095,43,2138
31220,"Ludington, MI",28954,Micropolitan Statistical Area,Black,0,0,0,No meaningful results,,,,96,7,103
31220,"Ludington, MI",28954,Micropolitan Statistical Area,Latino,1,1,0,No meaningful results,,,,96,7,103
31220,"Ludington, MI",28954,Micropolitan Statistical Area,Native American,1,1,0,No meaningful results,,,,96,7,103
31220,"Ludington, MI",28954,Micropolitan Statistical Area,AAPI,0,0,0,No meaningful results,,,,96,7,103
37540,"Paris, TN",32284,Micropolitan Statistical Area,Black,0,0,0,No meaningful results,,,,73,6,79
37540,"Paris, TN",32284,Micropolitan Statistical Area,Latino,2,2,0,No meaningful results,,,,73,6,79
37540,"Paris, TN",32284,Micropolitan Statistical Area,Native American,0,0,0,No meaningful results,,,,73,6,79
37540,"Paris, TN",32284,Micropolitan Statistical Area,AAPI,0,0,0,No meaningful results,,,,73,6,79
28820,"Kinston, NC",56756,Micropolitan Statistical Area,Black,24,17,7,No meaningful results,,,,124,8,132
28820,"Kinston, NC",56756,Micropolitan Statistical Area,Latino,7,6,1,No meaningful results,,,,124,8,132
28820,"Kinston, NC",56756,Micropolitan Statistical Area,Native American,0,0,0,No meaningful results,,,,124,8,132
28820,"Kinston, NC",56756,Micropolitan Statistical Area,AAPI,0,0,0,No meaningful results,,,,124,8,132
47820,"Washington, NC",47168,Micropolitan Statistical Area,Black,7,7,0,No meaningful results,,,,244,17,261
47820,"Washington, NC",47168,Micropolitan Statistical Area,Latino,6,6,0,No meaningful results,,,,244,17,261
47820,"Washington, NC",47168,Micropolitan Statistical Area,Native American,1,1,0,No meaningful results,,,,244,17,261
47820,"Washington, NC",47168,Micropolitan Statistical Area,AAPI,3,2,1,No meaningful results,,,,244,17,261
28620,"Kill Devil Hills, NC",36222,Micropolitan Statistical Area,Black,4,3,1,No meaningful results,,,,320,36,356
28620,"Kill Devil Hills, NC",36222,Micropolitan Statistical Area,Latino,11,10,1,No meaningful results,,,,320,36,356
28620,"Kill Devil Hills, NC",36222,Micropolitan Statistical Area,Native American,0,0,0,No meaningful results,,,,320,36,356
28620,"Kill Devil Hills, NC",36222,Micropolitan Statistical Area,AAPI,2,2,0,No meaningful results,,,,320,36,356
35100,"New Bern, NC",124786,Metropolitan Statistical Area,Black,32,27,5,Regression equation needs to be tweaked,1.543565056,1.5,15,628,42,670
35100,"New Bern, NC",124786,Metropolitan Statistical Area,Latino,16,14,2,Regression equation needs to be tweaked,0.839038236,0.8,8,628,42,670
35100,"New Bern, NC",124786,Metropolitan Statistical Area,Native American,2,2,0,Regression equation needs to be tweaked,2.11E-29,0,0,628,42,670
35100,"New Bern, NC",124786,Metropolitan Statistical Area,AAPI,17,12,5,Regression equation needs to be tweaked,5.366101752,5.4,54,628,42,670
34740,"Muskegon, MI",173297,Metropolitan Statistical Area,Black,15,15,0,Regression equation needs to be tweaked,1.04E-13,0,0,1089,44,1133
34740,"Muskegon, MI",173297,Metropolitan Statistical Area,Latino,25,23,2,Regression equation needs to be tweaked,0.966868019,1,10,1089,44,1133
34740,"Muskegon, MI",173297,Metropolitan Statistical Area,Native American,8,7,1,Regression equation needs to be tweaked,1.936205319,1.9,19,1089,44,1133
34740,"Muskegon, MI",173297,Metropolitan Statistical Area,AAPI,8,8,0,Regression equation needs to be tweaked,0.000836668,0,0,1089,44,1133
31300,"Lumberton, NC",132596,Micropolitan Statistical Area,Black,22,18,4,No meaningful results,,,,62,10,72
31300,"Lumberton, NC",132596,Micropolitan Statistical Area,Latino,6,6,0,No meaningful results,,,,62,10,72
31300,"Lumberton, NC",132596,Micropolitan Statistical Area,Native American,47,37,10,No meaningful results,,,,62,10,72
31300,"Lumberton, NC",132596,Micropolitan Statistical Area,AAPI,8,5,3,No meaningful results,,,,62,10,72
11100,"Amarillo, TX",263776,Metropolitan Statistical Area,Black,29,25,4,No meaningful results,,,,1092,40,1132
11100,"Amarillo, TX",263776,Metropolitan Statistical Area,Latino,221,210,11,No meaningful results,,,,1092,40,1132
11100,"Amarillo, TX",263776,Metropolitan Statistical Area,Native American,7,7,0,No meaningful results,,,,1092,40,1132
11100,"Amarillo, TX",263776,Metropolitan Statistical Area,AAPI,59,58,1,No meaningful results,,,,1092,40,1132
10860,"Alice, TX",52240,Micropolitan Statistical Area,Black,0,0,0,No meaningful results,,,,25,5,30
10860,"Alice, TX",52240,Micropolitan Statistical Area,Latino,44,36,8,No meaningful results,,,,25,5,30
10860,"Alice, TX",52240,Micropolitan Statistical Area,Native American,0,0,0,No meaningful results,,,,25,5,30
10860,"Alice, TX",52240,Micropolitan Statistical Area,AAPI,0,0,0,No meaningful results,,,,25,5,30
20300,"Dumas, TX",21399,Micropolitan Statistical Area,Black,0,0,0,No meaningful results,,,,29,2,31
20300,"Dumas, TX",21399,Micropolitan Statistical Area,Latino,22,20,2,No meaningful results,,,,29,2,31
20300,"Dumas, TX",21399,Micropolitan Statistical Area,Native American,0,0,0,No meaningful results,,,,29,2,31
20300,"Dumas, TX",21399,Micropolitan Statistical Area,AAPI,3,3,0,No meaningful results,,,,29,2,31
20900,"El Campo, TX",41577,Micropolitan Statistical Area,Black,3,3,0,No meaningful results,,,,77,7,84
20900,"El Campo, TX",41577,Micropolitan Statistical Area,Latino,33,26,7,No meaningful results,,,,77,7,84
20900,"El Campo, TX",41577,Micropolitan Statistical Area,Native American,0,0,0,No meaningful results,,,,77,7,84
20900,"El Campo, TX",41577,Micropolitan Statistical Area,AAPI,0,0,0,No meaningful results,,,,77,7,84
48660,"Wichita Falls, TX",150715,Metropolitan Statistical Area,Black,9,8,1,Regression equation needs to be tweaked,0.078206604,0.1,1,476,21,497
48660,"Wichita Falls, TX",150715,Metropolitan Statistical Area,Latino,59,53,6,Regression equation needs to be tweaked,4.134196223,4.1,41,476,21,497
48660,"Wichita Falls, TX",150715,Metropolitan Statistical Area,Native American,3,2,1,Regression equation needs to be tweaked,2.327891445,2.3,23,476,21,497
48660,"Wichita Falls, TX",150715,Metropolitan Statistical Area,AAPI,16,15,1,Regression equation needs to be tweaked,10.63167027,10.6,106,476,21,497
24940,"Greenwood, SC",70411,Micropolitan Statistical Area,Black,18,15,3,No meaningful results,,,,291,8,299
24940,"Greenwood, SC",70411,Micropolitan Statistical Area,Latino,10,9,1,No meaningful results,,,,291,8,299
24940,"Greenwood, SC",70411,Micropolitan Statistical Area,Native American,3,2,1,No meaningful results,,,,291,8,299
24940,"Greenwood, SC",70411,Micropolitan Statistical Area,AAPI,6,6,0,No meaningful results,,,,291,8,299
35140,"Newberry, SC",38194,Micropolitan Statistical Area,Black,4,3,1,No meaningful results,,,,100,15,115
35140,"Newberry, SC",38194,Micropolitan Statistical Area,Latino,3,2,1,No meaningful results,,,,100,15,115
35140,"Newberry, SC",38194,Micropolitan Statistical Area,Native American,0,0,0,No meaningful results,,,,100,15,115
35140,"Newberry, SC",38194,Micropolitan Statistical Area,AAPI,1,1,0,No meaningful results,,,,100,15,115
14300,"Bonham, TX",34537,Micropolitan Statistical Area,Black,4,2,2,No meaningful results,,,,103,12,115
14300,"Bonham, TX",34537,Micropolitan Statistical Area,Latino,10,7,3,No meaningful results,,,,103,12,115
14300,"Bonham, TX",34537,Micropolitan Statistical Area,Native American,0,0,0,No meaningful results,,,,103,12,115
14300,"Bonham, TX",34537,Micropolitan Statistical Area,AAPI,0,0,0,No meaningful results,,,,103,12,115
27180,"Jackson, TN",178442,Metropolitan Statistical Area,Black,45,39,6,Regression equation needs to be tweaked,1.961120608,2,20,649,39,688
27180,"Jackson, TN",178442,Metropolitan Statistical Area,Latino,19,16,3,Regression equation needs to be tweaked,4.698439349,4.7,47,649,39,688
27180,"Jackson, TN",178442,Metropolitan Statistical Area,Native American,2,2,0,Regression equation needs to be tweaked,4.17E-09,0,0,649,39,688
27180,"Jackson, TN",178442,Metropolitan Statistical Area,AAPI,19,15,4,Regression equation needs to be tweaked,15.38111853,15.4,154,649,39,688
46900,"Vernon, TX",12833,Micropolitan Statistical Area,Black,1,1,0,No meaningful results,,,,13,2,15
46900,"Vernon, TX",12833,Micropolitan Statistical Area,Latino,2,2,0,No meaningful results,,,,13,2,15
46900,"Vernon, TX",12833,Micropolitan Statistical Area,Native American,1,1,0,No meaningful results,,,,13,2,15
46900,"Vernon, TX",12833,Micropolitan Statistical Area,AAPI,4,4,0,No meaningful results,,,,13,2,15
31180,"Lubbock, TX",316474,Metropolitan Statistical Area,Black,53,46,7,Not enough of applications,3.543589516,3.5,35,1621,66,1687
31180,"Lubbock, TX",316474,Metropolitan Statistical Area,Latino,354,329,25,Not statistcially significant,1.469294826,1.5,15,1621,66,1687
31180,"Lubbock, TX",316474,Metropolitan Statistical Area,Native American,17,16,1,Not statistcially significant,2.224371672,2.2,22,1621,66,1687
31180,"Lubbock, TX",316474,Metropolitan Statistical Area,AAPI,90,84,6,Not statistcially significant,1.701320616,1.7,17,1621,66,1687
40530,"Rockport, TX",24462,Micropolitan Statistical Area,Black,0,0,0,No meaningful results,,,,105,10,115
40530,"Rockport, TX",24462,Micropolitan Statistical Area,Latino,10,10,0,No meaningful results,,,,105,10,115
40530,"Rockport, TX",24462,Micropolitan Statistical Area,Native American,3,2,1,No meaningful results,,,,105,10,115
40530,"Rockport, TX",24462,Micropolitan Statistical Area,AAPI,1,1,0,No meaningful results,,,,105,10,115
34860,"Nacogdoches, TX",65339,Micropolitan Statistical Area,Black,7,3,4,No meaningful results,,,,171,20,191
34860,"Nacogdoches, TX",65339,Micropolitan Statistical Area,Latino,36,33,3,No meaningful results,,,,171,20,191
34860,"Nacogdoches, TX",65339,Micropolitan Statistical Area,Native American,0,0,0,No meaningful results,,,,171,20,191
34860,"Nacogdoches, TX",65339,Micropolitan Statistical Area,AAPI,9,7,2,No meaningful results,,,,171,20,191
30020,"Lawton, OK",127620,Metropolitan Statistical Area,Black,14,11,3,No meaningful results,,,,159,15,174
30020,"Lawton, OK",127620,Metropolitan Statistical Area,Latino,10,8,2,No meaningful results,,,,159,15,174
30020,"Lawton, OK",127620,Metropolitan Statistical Area,Native American,10,9,1,No meaningful results,,,,159,15,174
30020,"Lawton, OK",127620,Metropolitan Statistical Area,AAPI,8,7,1,No meaningful results,,,,159,15,174
23240,"Fredericksburg, TX",26459,Micropolitan Statistical Area,Black,1,1,0,No meaningful results,,,,83,16,99
23240,"Fredericksburg, TX",26459,Micropolitan Statistical Area,Latino,7,7,0,No meaningful results,,,,83,16,99
23240,"Fredericksburg, TX",26459,Micropolitan Statistical Area,Native American,1,1,0,No meaningful results,,,,83,16,99
23240,"Fredericksburg, TX",26459,Micropolitan Statistical Area,AAPI,0,0,0,No meaningful results,,,,83,16,99
20140,"Dublin, GA",63891,Micropolitan Statistical Area,Black,20,16,4,No meaningful results,,,,100,13,113
20140,"Dublin, GA",63891,Micropolitan Statistical Area,Latino,5,4,1,No meaningful results,,,,100,13,113
20140,"Dublin, GA",63891,Micropolitan Statistical Area,Native American,0,0,0,No meaningful results,,,,100,13,113
20140,"Dublin, GA",63891,Micropolitan Statistical Area,AAPI,3,3,0,No meaningful results,,,,100,13,113
38500,"Plymouth, IN",46461,Micropolitan Statistical Area,Black,1,1,0,No meaningful results,,,,290,15,305
38500,"Plymouth, IN",46461,Micropolitan Statistical Area,Latino,34,26,8,No meaningful results,,,,290,15,305
38500,"Plymouth, IN",46461,Micropolitan Statistical Area,Native American,0,0,0,No meaningful results,,,,290,15,305
38500,"Plymouth, IN",46461,Micropolitan Statistical Area,AAPI,1,1,0,No meaningful results,,,,290,15,305
19540,"Decatur, IN",35376,Micropolitan Statistical Area,Black,1,0,1,No meaningful results,,,,165,17,182
19540,"Decatur, IN",35376,Micropolitan Statistical Area,Latino,7,4,3,No meaningful results,,,,165,17,182
19540,"Decatur, IN",35376,Micropolitan Statistical Area,Native American,0,0,0,No meaningful results,,,,165,17,182
19540,"Decatur, IN",35376,Micropolitan Statistical Area,AAPI,2,1,1,No meaningful results,,,,165,17,182
30700,"Lincoln, NE",330329,Metropolitan Statistical Area,Black,43,39,4,No meaningful results,,,,2535,56,2591
30700,"Lincoln, NE",330329,Metropolitan Statistical Area,Latino,106,95,11,No meaningful results,,,,2535,56,2591
30700,"Lincoln, NE",330329,Metropolitan Statistical Area,Native American,6,6,0,No meaningful results,,,,2535,56,2591
30700,"Lincoln, NE",330329,Metropolitan Statistical Area,AAPI,143,135,8,No meaningful results,,,,2535,56,2591
31860,"Mankato, MN",100749,Metropolitan Statistical Area,Black,6,5,1,No meaningful results,,,,493,29,522
31860,"Mankato, MN",100749,Metropolitan Statistical Area,Latino,16,13,3,No meaningful results,,,,493,29,522
31860,"Mankato, MN",100749,Metropolitan Statistical Area,Native American,4,4,0,No meaningful results,,,,493,29,522
31860,"Mankato, MN",100749,Metropolitan Statistical Area,AAPI,19,18,1,No meaningful results,,,,493,29,522
32860,"Menomonie, WI",44759,Micropolitan Statistical Area,Black,0,0,0,No meaningful results,,,,223,27,250
32860,"Menomonie, WI",44759,Micropolitan Statistical Area,Latino,1,0,1,No meaningful results,,,,223,27,250
32860,"Menomonie, WI",44759,Micropolitan Statistical Area,Native American,0,0,0,No meaningful results,,,,223,27,250
32860,"Menomonie, WI",44759,Micropolitan Statistical Area,AAPI,12,9,3,No meaningful results,,,,223,27,250
16460,"Centralia, IL",37743,Micropolitan Statistical Area,Black,2,1,1,No meaningful results,,,,59,4,63
16460,"Centralia, IL",37743,Micropolitan Statistical Area,Latino,1,1,0,No meaningful results,,,,59,4,63
16460,"Centralia, IL",37743,Micropolitan Statistical Area,Native American,0,0,0,No meaningful results,,,,59,4,63
16460,"Centralia, IL",37743,Micropolitan Statistical Area,AAPI,3,2,1,No meaningful results,,,,59,4,63
44020,"Spirit Lake, IA",17127,Micropolitan Statistical Area,Black,0,0,0,No meaningful results,,,,161,9,170
44020,"Spirit Lake, IA",17127,Micropolitan Statistical Area,Latino,2,1,1,No meaningful results,,,,161,9,170
44020,"Spirit Lake, IA",17127,Micropolitan Statistical Area,Native American,0,0,0,No meaningful results,,,,161,9,170
44020,"Spirit Lake, IA",17127,Micropolitan Statistical Area,AAPI,1,1,0,No meaningful results,,,,161,9,170
49220,"Wisconsin Rapids-Marshfield, WI",73112,Micropolitan Statistical Area,Black,1,1,0,No meaningful results,,,,218,17,235
49220,"Wisconsin Rapids-Marshfield, WI",73112,Micropolitan Statistical Area,Latino,4,4,0,No meaningful results,,,,218,17,235
49220,"Wisconsin Rapids-Marshfield, WI",73112,Micropolitan Statistical Area,Native American,2,2,0,No meaningful results,,,,218,17,235
49220,"Wisconsin Rapids-Marshfield, WI",73112,Micropolitan Statistical Area,AAPI,8,8,0,No meaningful results,,,,218,17,235
49460,"Yankton, SD",22717,Micropolitan Statistical Area,Black,0,0,0,No meaningful results,,,,142,7,149
49460,"Yankton, SD",22717,Micropolitan Statistical Area,Latino,0,0,0,No meaningful results,,,,142,7,149
49460,"Yankton, SD",22717,Micropolitan Statistical Area,Native American,0,0,0,No meaningful results,,,,142,7,149
49460,"Yankton, SD",22717,Micropolitan Statistical Area,AAPI,1,1,0,No meaningful results,,,,142,7,149
44740,"Storm Lake, IA",20058,Micropolitan Statistical Area,Black,0,0,0,No meaningful results,,,,74,2,76
44740,"Storm Lake, IA",20058,Micropolitan Statistical Area,Latino,35,34,1,No meaningful results,,,,74,2,76
44740,"Storm Lake, IA",20058,Micropolitan Statistical Area,Native American,0,0,0,No meaningful results,,,,74,2,76
44740,"Storm Lake, IA",20058,Micropolitan Statistical Area,AAPI,19,19,0,No meaningful results,,,,74,2,76
18820,"Crawfordsville, IN",38287,Micropolitan Statistical Area,Black,0,0,0,No meaningful results,,,,203,7,210
18820,"Crawfordsville, IN",38287,Micropolitan Statistical Area,Latino,4,4,0,No meaningful results,,,,203,7,210
18820,"Crawfordsville, IN",38287,Micropolitan Statistical Area,Native American,0,0,0,No meaningful results,,,,203,7,210
18820,"Crawfordsville, IN",38287,Micropolitan Statistical Area,AAPI,0,0,0,No meaningful results,,,,203,7,210
43980,"Spencer, IA",16211,Micropolitan Statistical Area,Black,0,0,0,No meaningful results,,,,92,5,97
43980,"Spencer, IA",16211,Micropolitan Statistical Area,Latino,1,1,0,No meaningful results,,,,92,5,97
43980,"Spencer, IA",16211,Micropolitan Statistical Area,Native American,0,0,0,No meaningful results,,,,92,5,97
43980,"Spencer, IA",16211,Micropolitan Statistical Area,AAPI,1,1,0,No meaningful results,,,,92,5,97
14160,,,,Black,0,0,0,No meaningful results,,,,185,2,187
14160,,,,Latino,2,1,1,No meaningful results,,,,185,2,187
14160,,,,Native American,0,0,0,No meaningful results,,,,185,2,187
14160,,,,AAPI,1,0,1,No meaningful results,,,,185,2,187
26340,"Houghton, MI",38181,Micropolitan Statistical Area,Black,1,1,0,No meaningful results,,,,73,7,80
26340,"Houghton, MI",38181,Micropolitan Statistical Area,Latino,1,1,0,No meaningful results,,,,73,7,80
26340,"Houghton, MI",38181,Micropolitan Statistical Area,Native American,1,1,0,No meaningful results,,,,73,7,80
26340,"Houghton, MI",38181,Micropolitan Statistical Area,AAPI,4,3,1,No meaningful results,,,,73,7,80
34500,"Mount Vernon, IL",37985,Micropolitan Statistical Area,Black,1,1,0,No meaningful results,,,,102,8,110
34500,"Mount Vernon, IL",37985,Micropolitan Statistical Area,Latino,3,3,0,No meaningful results,,,,102,8,110
34500,"Mount Vernon, IL",37985,Micropolitan Statistical Area,Native American,0,0,0,No meaningful results,,,,102,8,110
34500,"Mount Vernon, IL",37985,Micropolitan Statistical Area,AAPI,3,3,0,No meaningful results,,,,102,8,110
15780,"Camden, AR",29022,Micropolitan Statistical Area,Black,6,5,1,No meaningful results,,,,44,4,48
15780,"Camden, AR",29022,Micropolitan Statistical Area,Latino,5,5,0,No meaningful results,,,,44,4,48
15780,"Camden, AR",29022,Micropolitan Statistical Area,Native American,0,0,0,No meaningful results,,,,44,4,48
15780,"Camden, AR",29022,Micropolitan Statistical Area,AAPI,2,2,0,No meaningful results,,,,44,4,48
11860,"Atchison, KS",16268,Micropolitan Statistical Area,Black,0,0,0,No meaningful results,,,,33,2,35
11860,"Atchison, KS",16268,Micropolitan Statistical Area,Latino,4,2,2,No meaningful results,,,,33,2,35
11860,"Atchison, KS",16268,Micropolitan Statistical Area,Native American,1,1,0,No meaningful results,,,,33,2,35
11860,"Atchison, KS",16268,Micropolitan Statistical Area,AAPI,0,0,0,No meaningful results,,,,33,2,35
41140,"St. Joseph, MO-KS",126173,Metropolitan Statistical Area,Black,9,9,0,No meaningful results,,,,448,21,469
41140,"St. Joseph, MO-KS",126173,Metropolitan Statistical Area,Latino,22,21,1,No meaningful results,,,,448,21,469
41140,"St. Joseph, MO-KS",126173,Metropolitan Statistical Area,Native American,3,3,0,No meaningful results,,,,448,21,469
41140,"St. Joseph, MO-KS",126173,Metropolitan Statistical Area,AAPI,10,9,1,No meaningful results,,,,448,21,469
28260,"Kearney, NE",55738,Micropolitan Statistical Area,Black,0,0,0,No meaningful results,,,,273,8,281
28260,"Kearney, NE",55738,Micropolitan Statistical Area,Latino,18,17,1,No meaningful results,,,,273,8,281
28260,"Kearney, NE",55738,Micropolitan Statistical Area,Native American,0,0,0,No meaningful results,,,,273,8,281
28260,"Kearney, NE",55738,Micropolitan Statistical Area,AAPI,2,2,0,No meaningful results,,,,273,8,281
21380,"Emporia, KS",35888,Micropolitan Statistical Area,Black,5,4,1,No meaningful results,,,,106,9,115
21380,"Emporia, KS",35888,Micropolitan Statistical Area,Latino,33,26,7,No meaningful results,,,,106,9,115
21380,"Emporia, KS",35888,Micropolitan Statistical Area,Native American,0,0,0,No meaningful results,,,,106,9,115
21380,"Emporia, KS",35888,Micropolitan Statistical Area,AAPI,1,1,0,No meaningful results,,,,106,9,115
26090,"Holland, MI",116143,Micropolitan Statistical Area,Black,5,5,0,No meaningful results,,,,868,46,914
26090,"Holland, MI",116143,Micropolitan Statistical Area,Latino,37,35,2,No meaningful results,,,,868,46,914
26090,"Holland, MI",116143,Micropolitan Statistical Area,Native American,7,4,3,No meaningful results,,,,868,46,914
26090,"Holland, MI",116143,Micropolitan Statistical Area,AAPI,7,6,1,No meaningful results,,,,868,46,914
15940,"Canton-Massillon, OH",399736,Metropolitan Statistical Area,Black,46,43,3,Regression equation needs to be tweaked,1.486966957,1.5,15,2286,112,2398
15940,"Canton-Massillon, OH",399736,Metropolitan Statistical Area,Latino,28,27,1,Regression equation needs to be tweaked,0.38401272,0.4,4,2286,112,2398
15940,"Canton-Massillon, OH",399736,Metropolitan Statistical Area,Native American,5,4,1,Regression equation needs to be tweaked,3.440006299,3.4,34,2286,112,2398
15940,"Canton-Massillon, OH",399736,Metropolitan Statistical Area,AAPI,30,24,6,Regression equation needs to be tweaked,3.792113224,3.8,38,2286,112,2398
40620,"Rolla, MO",44630,Micropolitan Statistical Area,Black,0,0,0,No meaningful results,,,,93,7,100
40620,"Rolla, MO",44630,Micropolitan Statistical Area,Latino,2,2,0,No meaningful results,,,,93,7,100
40620,"Rolla, MO",44630,Micropolitan Statistical Area,Native American,0,0,0,No meaningful results,,,,93,7,100
40620,"Rolla, MO",44630,Micropolitan Statistical Area,AAPI,1,1,0,No meaningful results,,,,93,7,100
38260,"Pittsburg, KS",38968,Micropolitan Statistical Area,Black,0,0,0,No meaningful results,,,,121,11,132
38260,"Pittsburg, KS",38968,Micropolitan Statistical Area,Latino,5,5,0,No meaningful results,,,,121,11,132
38260,"Pittsburg, KS",38968,Micropolitan Statistical Area,Native American,1,1,0,No meaningful results,,,,121,11,132
38260,"Pittsburg, KS",38968,Micropolitan Statistical Area,AAPI,2,2,0,No meaningful results,,,,121,11,132
31930,"Marietta, OH",60426,Micropolitan Statistical Area,Black,1,1,0,No meaningful results,,,,271,11,282
31930,"Marietta, OH",60426,Micropolitan Statistical Area,Latino,7,7,0,No meaningful results,,,,271,11,282
31930,"Marietta, OH",60426,Micropolitan Statistical Area,Native American,1,1,0,No meaningful results,,,,271,11,282
31930,"Marietta, OH",60426,Micropolitan Statistical Area,AAPI,0,0,0,No meaningful results,,,,271,11,282
14700,"Branson, MO",55114,Micropolitan Statistical Area,Black,1,1,0,No meaningful results,,,,267,25,292
14700,"Branson, MO",55114,Micropolitan Statistical Area,Latino,7,5,2,No meaningful results,,,,267,25,292
14700,"Branson, MO",55114,Micropolitan Statistical Area,Native American,1,1,0,No meaningful results,,,,267,25,292
14700,"Branson, MO",55114,Micropolitan Statistical Area,AAPI,3,3,0,No meaningful results,,,,267,25,292
27940,"Juneau, AK",32227,Micropolitan Statistical Area,Black,2,2,0,No meaningful results,,,,159,5,164
27940,"Juneau, AK",32227,Micropolitan Statistical Area,Latino,8,8,0,No meaningful results,,,,159,5,164
27940,"Juneau, AK",32227,Micropolitan Statistical Area,Native American,14,13,1,No meaningful results,,,,159,5,164
27940,"Juneau, AK",32227,Micropolitan Statistical Area,AAPI,11,9,2,No meaningful results,,,,159,5,164
21060,"Elizabethtown-Fort Knox, KY",150913,Metropolitan Statistical Area,Black,21,15,6,No meaningful results,,,,462,70,532
21060,"Elizabethtown-Fort Knox, KY",150913,Metropolitan Statistical Area,Latino,21,18,3,No meaningful results,,,,462,70,532
21060,"Elizabethtown-Fort Knox, KY",150913,Metropolitan Statistical Area,Native American,1,1,0,No meaningful results,,,,462,70,532
21060,"Elizabethtown-Fort Knox, KY",150913,Metropolitan Statistical Area,AAPI,12,10,2,No meaningful results,,,,462,70,532
47420,"Wahpeton, ND-MN",22545,Micropolitan Statistical Area,Black,0,0,0,No meaningful results,,,,129,5,134
47420,"Wahpeton, ND-MN",22545,Micropolitan Statistical Area,Latino,1,1,0,No meaningful results,,,,129,5,134
47420,"Wahpeton, ND-MN",22545,Micropolitan Statistical Area,Native American,1,0,1,No meaningful results,,,,129,5,134
47420,"Wahpeton, ND-MN",22545,Micropolitan Statistical Area,AAPI,2,2,0,No meaningful results,,,,129,5,134
10820,"Alexandria, MN",37513,Micropolitan Statistical Area,Black,1,1,0,No meaningful results,,,,259,15,274
10820,"Alexandria, MN",37513,Micropolitan Statistical Area,Latino,1,1,0,No meaningful results,,,,259,15,274
10820,"Alexandria, MN",37513,Micropolitan Statistical Area,Native American,1,1,0,No meaningful results,,,,259,15,274
10820,"Alexandria, MN",37513,Micropolitan Statistical Area,AAPI,2,2,0,No meaningful results,,,,259,15,274
48820,"Willmar, MN",42841,Micropolitan Statistical Area,Black,2,2,0,No meaningful results,,,,168,12,180
48820,"Willmar, MN",42841,Micropolitan Statistical Area,Latino,10,8,2,No meaningful results,,,,168,12,180
48820,"Willmar, MN",42841,Micropolitan Statistical Area,Native American,0,0,0,No meaningful results,,,,168,12,180
48820,"Willmar, MN",42841,Micropolitan Statistical Area,AAPI,4,4,0,No meaningful results,,,,168,12,180
22260,"Fergus Falls, MN",58195,Micropolitan Statistical Area,Black,0,0,0,No meaningful results,,,,322,24,346
22260,"Fergus Falls, MN",58195,Micropolitan Statistical Area,Latino,8,8,0,No meaningful results,,,,322,24,346
22260,"Fergus Falls, MN",58195,Micropolitan Statistical Area,Native American,2,1,1,No meaningful results,,,,322,24,346
22260,"Fergus Falls, MN",58195,Micropolitan Statistical Area,AAPI,7,7,0,No meaningful results,,,,322,24,346
45000,"Susanville, CA",30818,Micropolitan Statistical Area,Black,0,0,0,No meaningful results,,,,78,6,84
45000,"Susanville, CA",30818,Micropolitan Statistical Area,Latino,12,10,2,No meaningful results,,,,78,6,84
45000,"Susanville, CA",30818,Micropolitan Statistical Area,Native American,3,2,1,No meaningful results,,,,78,6,84
45000,"Susanville, CA",30818,Micropolitan Statistical Area,AAPI,3,1,2,No meaningful results,,,,78,6,84
41660,"San Angelo, TX",120837,Metropolitan Statistical Area,Black,6,6,0,No meaningful results,,,,417,16,433
41660,"San Angelo, TX",120837,Metropolitan Statistical Area,Latino,134,124,10,No meaningful results,,,,417,16,433
41660,"San Angelo, TX",120837,Metropolitan Statistical Area,Native American,3,3,0,No meaningful results,,,,417,16,433
41660,"San Angelo, TX",120837,Metropolitan Statistical Area,AAPI,12,12,0,No meaningful results,,,,417,16,433
13300,"Beeville, TX",32611,Micropolitan Statistical Area,Black,1,1,0,No meaningful results,,,,30,4,34
13300,"Beeville, TX",32611,Micropolitan Statistical Area,Latino,25,19,6,No meaningful results,,,,30,4,34
13300,"Beeville, TX",32611,Micropolitan Statistical Area,Native American,0,0,0,No meaningful results,,,,30,4,34
13300,"Beeville, TX",32611,Micropolitan Statistical Area,AAPI,1,0,1,No meaningful results,,,,30,4,34
10180,"Abilene, TX",170669,Metropolitan Statistical Area,Black,19,18,1,No meaningful results,,,,687,19,706
10180,"Abilene, TX",170669,Metropolitan Statistical Area,Latino,84,81,3,No meaningful results,,,,687,19,706
10180,"Abilene, TX",170669,Metropolitan Statistical Area,Native American,5,5,0,No meaningful results,,,,687,19,706
10180,"Abilene, TX",170669,Metropolitan Statistical Area,AAPI,26,24,2,No meaningful results,,,,687,19,706
14420,"Borger, TX",21344,Micropolitan Statistical Area,Black,2,2,0,No meaningful results,,,,67,2,69
14420,"Borger, TX",21344,Micropolitan Statistical Area,Latino,11,11,0,No meaningful results,,,,67,2,69
14420,"Borger, TX",21344,Micropolitan Statistical Area,Native American,2,1,1,No meaningful results,,,,67,2,69
14420,"Borger, TX",21344,Micropolitan Statistical Area,AAPI,0,0,0,No meaningful results,,,,67,2,69
18620,"Corsicana, TX",48995,Micropolitan Statistical Area,Black,2,2,0,No meaningful results,,,,114,10,124
18620,"Corsicana, TX",48995,Micropolitan Statistical Area,Latino,30,22,8,No meaningful results,,,,114,10,124
18620,"Corsicana, TX",48995,Micropolitan Statistical Area,Native American,1,1,0,No meaningful results,,,,114,10,124
18620,"Corsicana, TX",48995,Micropolitan Statistical Area,AAPI,3,2,1,No meaningful results,,,,114,10,124
46020,"Truckee-Grass Valley, CA",99244,Micropolitan Statistical Area,Black,0,0,0,No meaningful results,,,,669,46,715
46020,"Truckee-Grass Valley, CA",99244,Micropolitan Statistical Area,Latino,43,39,4,No meaningful results,,,,669,46,715
46020,"Truckee-Grass Valley, CA",99244,Micropolitan Statistical Area,Native American,6,6,0,No meaningful results,,,,669,46,715
46020,"Truckee-Grass Valley, CA",99244,Micropolitan Statistical Area,AAPI,14,14,0,No meaningful results,,,,669,46,715
24460,"Great Bend, KS",26453,Micropolitan Statistical Area,Black,0,0,0,No meaningful results,,,,81,8,89
24460,"Great Bend, KS",26453,Micropolitan Statistical Area,Latino,4,3,1,No meaningful results,,,,81,8,89
24460,"Great Bend, KS",26453,Micropolitan Statistical Area,Native American,0,0,0,No meaningful results,,,,81,8,89
24460,"Great Bend, KS",26453,Micropolitan Statistical Area,AAPI,0,0,0,No meaningful results,,,,81,8,89
24260,"Grand Island, NE",75480,Metropolitan Statistical Area,Black,3,3,0,No meaningful results,,,,257,11,268
24260,"Grand Island, NE",75480,Metropolitan Statistical Area,Latino,75,69,6,No meaningful results,,,,257,11,268
24260,"Grand Island, NE",75480,Metropolitan Statistical Area,Native American,1,1,0,No meaningful results,,,,257,11,268
24260,"Grand Island, NE",75480,Metropolitan Statistical Area,AAPI,3,3,0,No meaningful results,,,,257,11,268
43580,"Sioux City, IA-NE-SD",143846,Metropolitan Statistical Area,Black,32,28,4,No meaningful results,,,,702,28,730
43580,"Sioux City, IA-NE-SD",143846,Metropolitan Statistical Area,Latino,142,120,22,No meaningful results,,,,702,28,730
43580,"Sioux City, IA-NE-SD",143846,Metropolitan Statistical Area,Native American,3,3,0,No meaningful results,,,,702,28,730
43580,"Sioux City, IA-NE-SD",143846,Metropolitan Statistical Area,AAPI,27,24,3,No meaningful results,,,,702,28,730
46820,"Vermillion, SD",13957,Micropolitan Statistical Area,Black,0,0,0,No meaningful results,,,,70,0,70
46820,"Vermillion, SD",13957,Micropolitan Statistical Area,Latino,2,2,0,No meaningful results,,,,70,0,70
46820,"Vermillion, SD",13957,Micropolitan Statistical Area,Native American,1,1,0,No meaningful results,,,,70,0,70
46820,"Vermillion, SD",13957,Micropolitan Statistical Area,AAPI,0,0,0,No meaningful results,,,,70,0,70
35740,"Norfolk, NE",48181,Micropolitan Statistical Area,Black,1,1,0,No meaningful results,,,,156,8,164
35740,"Norfolk, NE",48181,Micropolitan Statistical Area,Latino,26,24,2,No meaningful results,,,,156,8,164
35740,"Norfolk, NE",48181,Micropolitan Statistical Area,Native American,1,0,1,No meaningful results,,,,156,8,164
35740,"Norfolk, NE",48181,Micropolitan Statistical Area,AAPI,1,1,0,No meaningful results,,,,156,8,164
42740,"Sedalia, MO",42355,Micropolitan Statistical Area,Black,0,0,0,No meaningful results,,,,108,12,120
42740,"Sedalia, MO",42355,Micropolitan Statistical Area,Latino,9,8,1,No meaningful results,,,,108,12,120
42740,"Sedalia, MO",42355,Micropolitan Statistical Area,Native American,1,1,0,No meaningful results,,,,108,12,120
42740,"Sedalia, MO",42355,Micropolitan Statistical Area,AAPI,1,1,0,No meaningful results,,,,108,12,120
32140,"Marshall, MN",25758,Micropolitan Statistical Area,Black,0,0,0,No meaningful results,,,,124,3,127
32140,"Marshall, MN",25758,Micropolitan Statistical Area,Latino,3,3,0,No meaningful results,,,,124,3,127
32140,"Marshall, MN",25758,Micropolitan Statistical Area,Native American,1,1,0,No meaningful results,,,,124,3,127
32140,"Marshall, MN",25758,Micropolitan Statistical Area,AAPI,7,6,1,No meaningful results,,,,124,3,127
43260,"Sheridan, WY",30140,Micropolitan Statistical Area,Black,0,0,0,No meaningful results,,,,119,10,129
43260,"Sheridan, WY",30140,Micropolitan Statistical Area,Latino,5,5,0,No meaningful results,,,,119,10,129
43260,"Sheridan, WY",30140,Micropolitan Statistical Area,Native American,0,0,0,No meaningful results,,,,119,10,129
43260,"Sheridan, WY",30140,Micropolitan Statistical Area,AAPI,1,1,0,No meaningful results,,,,119,10,129
13100,"Beatrice, NE",21594,Micropolitan Statistical Area,Black,1,1,0,No meaningful results,,,,67,2,69
13100,"Beatrice, NE",21594,Micropolitan Statistical Area,Latino,1,1,0,No meaningful results,,,,67,2,69
13100,"Beatrice, NE",21594,Micropolitan Statistical Area,Native American,0,0,0,No meaningful results,,,,67,2,69
13100,"Beatrice, NE",21594,Micropolitan Statistical Area,AAPI,0,0,0,No meaningful results,,,,67,2,69
36900,"Ottumwa, IA",35141,Micropolitan Statistical Area,Black,4,4,0,No meaningful results,,,,144,13,157
36900,"Ottumwa, IA",35141,Micropolitan Statistical Area,Latino,31,30,1,No meaningful results,,,,144,13,157
36900,"Ottumwa, IA",35141,Micropolitan Statistical Area,Native American,0,0,0,No meaningful results,,,,144,13,157
36900,"Ottumwa, IA",35141,Micropolitan Statistical Area,AAPI,4,4,0,No meaningful results,,,,144,13,157
48780,"Williston, ND",35208,Micropolitan Statistical Area,Black,3,2,1,No meaningful results,,,,225,13,238
48780,"Williston, ND",35208,Micropolitan Statistical Area,Latino,11,9,2,No meaningful results,,,,225,13,238
48780,"Williston, ND",35208,Micropolitan Statistical Area,Native American,2,2,0,No meaningful results,,,,225,13,238
48780,"Williston, ND",35208,Micropolitan Statistical Area,AAPI,1,1,0,No meaningful results,,,,225,13,238
35820,"North Platte, NE",36585,Micropolitan Statistical Area,Black,0,0,0,No meaningful results,,,,138,9,147
35820,"North Platte, NE",36585,Micropolitan Statistical Area,Latino,3,3,0,No meaningful results,,,,138,9,147
35820,"North Platte, NE",36585,Micropolitan Statistical Area,Native American,0,0,0,No meaningful results,,,,138,9,147
35820,"North Platte, NE",36585,Micropolitan Statistical Area,AAPI,2,2,0,No meaningful results,,,,138,9,147
23340,"Fremont, NE",36665,Micropolitan Statistical Area,Black,1,1,0,No meaningful results,,,,197,4,201
23340,"Fremont, NE",36665,Micropolitan Statistical Area,Latino,26,23,3,No meaningful results,,,,197,4,201
23340,"Fremont, NE",36665,Micropolitan Statistical Area,Native American,1,1,0,No meaningful results,,,,197,4,201
23340,"Fremont, NE",36665,Micropolitan Statistical Area,AAPI,2,2,0,No meaningful results,,,,197,4,201
21420,"Enid, OK",61898,Metropolitan Statistical Area,Black,0,0,0,No meaningful results,,,,162,6,168
21420,"Enid, OK",61898,Metropolitan Statistical Area,Latino,24,23,1,No meaningful results,,,,162,6,168
21420,"Enid, OK",61898,Metropolitan Statistical Area,Native American,5,3,2,No meaningful results,,,,162,6,168
21420,"Enid, OK",61898,Metropolitan Statistical Area,AAPI,3,2,1,No meaningful results,,,,162,6,168
10220,"Ada, OK",38355,Micropolitan Statistical Area,Black,2,2,0,No meaningful results,,,,63,3,66
10220,"Ada, OK",38355,Micropolitan Statistical Area,Latino,4,4,0,No meaningful results,,,,63,3,66
10220,"Ada, OK",38355,Micropolitan Statistical Area,Native American,14,13,1,No meaningful results,,,,63,3,66
10220,"Ada, OK",38355,Micropolitan Statistical Area,AAPI,1,1,0,No meaningful results,,,,63,3,66
23780,"Garden City, KS",40657,Micropolitan Statistical Area,Black,0,0,0,No meaningful results,,,,80,4,84
23780,"Garden City, KS",40657,Micropolitan Statistical Area,Latino,61,60,1,No meaningful results,,,,80,4,84
23780,"Garden City, KS",40657,Micropolitan Statistical Area,Native American,0,0,0,No meaningful results,,,,80,4,84
23780,"Garden City, KS",40657,Micropolitan Statistical Area,AAPI,9,8,1,No meaningful results,,,,80,4,84
32340,"Maryville, MO",22359,Micropolitan Statistical Area,Black,0,0,0,No meaningful results,,,,70,7,77
32340,"Maryville, MO",22359,Micropolitan Statistical Area,Latino,2,2,0,No meaningful results,,,,70,7,77
32340,"Maryville, MO",22359,Micropolitan Statistical Area,Native American,0,0,0,No meaningful results,,,,70,7,77
32340,"Maryville, MO",22359,Micropolitan Statistical Area,AAPI,1,0,1,No meaningful results,,,,70,7,77
18100,"Columbus, NE",33174,Micropolitan Statistical Area,Black,4,4,0,No meaningful results,,,,119,4,123
18100,"Columbus, NE",33174,Micropolitan Statistical Area,Latino,34,32,2,No meaningful results,,,,119,4,123
18100,"Columbus, NE",33174,Micropolitan Statistical Area,Native American,0,0,0,No meaningful results,,,,119,4,123
18100,"Columbus, NE",33174,Micropolitan Statistical Area,AAPI,1,1,0,No meaningful results,,,,119,4,123
13900,"Bismarck, ND",127503,Metropolitan Statistical Area,Black,8,7,1,No meaningful results,,,,869,40,909
13900,"Bismarck, ND",127503,Metropolitan Statistical Area,Latino,12,12,0,No meaningful results,,,,869,40,909
13900,"Bismarck, ND",127503,Metropolitan Statistical Area,Native American,20,17,3,No meaningful results,,,,869,40,909
13900,"Bismarck, ND",127503,Metropolitan Statistical Area,AAPI,7,7,0,No meaningful results,,,,869,40,909
11620,"Ardmore, OK",58382,Micropolitan Statistical Area,Black,5,2,3,No meaningful results,,,,140,10,150
11620,"Ardmore, OK",58382,Micropolitan Statistical Area,Latino,12,12,0,No meaningful results,,,,140,10,150
11620,"Ardmore, OK",58382,Micropolitan Statistical Area,Native American,14,14,0,No meaningful results,,,,140,10,150
11620,"Ardmore, OK",58382,Micropolitan Statistical Area,AAPI,5,4,1,No meaningful results,,,,140,10,150
49380,"Worthington, MN",21734,Micropolitan Statistical Area,Black,3,1,2,No meaningful results,,,,41,0,41
49380,"Worthington, MN",21734,Micropolitan Statistical Area,Latino,7,6,1,No meaningful results,,,,41,0,41
49380,"Worthington, MN",21734,Micropolitan Statistical Area,Native American,1,1,0,No meaningful results,,,,41,0,41
49380,"Worthington, MN",21734,Micropolitan Statistical Area,AAPI,2,2,0,No meaningful results,,,,41,0,41
30300,"Lewiston, ID-WA",62638,Metropolitan Statistical Area,Black,0,0,0,No meaningful results,,,,367,21,388
30300,"Lewiston, ID-WA",62638,Metropolitan Statistical Area,Latino,10,9,1,No meaningful results,,,,367,21,388
30300,"Lewiston, ID-WA",62638,Metropolitan Statistical Area,Native American,6,6,0,No meaningful results,,,,367,21,388
30300,"Lewiston, ID-WA",62638,Metropolitan Statistical Area,AAPI,4,4,0,No meaningful results,,,,367,21,388
19980,"Dodge City, KS",34179,Micropolitan Statistical Area,Black,1,1,0,No meaningful results,,,,57,1,58
19980,"Dodge City, KS",34179,Micropolitan Statistical Area,Latino,50,44,6,No meaningful results,,,,57,1,58
19980,"Dodge City, KS",34179,Micropolitan Statistical Area,Native American,1,1,0,No meaningful results,,,,57,1,58
19980,"Dodge City, KS",34179,Micropolitan Statistical Area,AAPI,4,4,0,No meaningful results,,,,57,1,58
27420,"Jamestown, ND",20965,Micropolitan Statistical Area,Black,0,0,0,No meaningful results,,,,83,3,86
27420,"Jamestown, ND",20965,Micropolitan Statistical Area,Latino,1,1,0,No meaningful results,,,,83,3,86
27420,"Jamestown, ND",20965,Micropolitan Statistical Area,Native American,1,0,1,No meaningful results,,,,83,3,86
27420,"Jamestown, ND",20965,Micropolitan Statistical Area,AAPI,0,0,0,No meaningful results,,,,83,3,86
26540,"Huntington, IN",36359,Micropolitan Statistical Area,Black,1,1,0,No meaningful results,,,,260,13,273
26540,"Huntington, IN",36359,Micropolitan Statistical Area,Latino,6,6,0,No meaningful results,,,,260,13,273
26540,"Huntington, IN",36359,Micropolitan Statistical Area,Native American,1,1,0,No meaningful results,,,,260,13,273
26540,"Huntington, IN",36359,Micropolitan Statistical Area,AAPI,0,0,0,No meaningful results,,,,260,13,273
17740,"Coldwater, MI",43513,Micropolitan Statistical Area,Black,1,1,0,No meaningful results,,,,150,8,158
17740,"Coldwater, MI",43513,Micropolitan Statistical Area,Latino,7,6,1,No meaningful results,,,,150,8,158
17740,"Coldwater, MI",43513,Micropolitan Statistical Area,Native American,1,0,1,No meaningful results,,,,150,8,158
17740,"Coldwater, MI",43513,Micropolitan Statistical Area,AAPI,0,0,0,No meaningful results,,,,150,8,158
31980,"Marion, IN",66452,Micropolitan Statistical Area,Black,13,10,3,Regression equation needs to be tweaked,7.441394106,7.4,74,291,22,313
31980,"Marion, IN",66452,Micropolitan Statistical Area,Latino,9,7,2,Regression equation needs to be tweaked,5.493143084,5.5,55,291,22,313
31980,"Marion, IN",66452,Micropolitan Statistical Area,Native American,1,1,0,Regression equation needs to be tweaked,1.10E-06,0,0,291,22,313
31980,"Marion, IN",66452,Micropolitan Statistical Area,AAPI,3,3,0,Regression equation needs to be tweaked,3.42E-07,0,0,291,22,313
47340,"Wabash, IN",31389,Micropolitan Statistical Area,Black,0,0,0,No meaningful results,,,,134,10,144
47340,"Wabash, IN",31389,Micropolitan Statistical Area,Latino,1,1,0,No meaningful results,,,,134,10,144
47340,"Wabash, IN",31389,Micropolitan Statistical Area,Native American,0,0,0,No meaningful results,,,,134,10,144
47340,"Wabash, IN",31389,Micropolitan Statistical Area,AAPI,1,1,0,No meaningful results,,,,134,10,144
19580,"Defiance, OH",38160,Micropolitan Statistical Area,Black,2,2,0,No meaningful results,,,,203,11,214
19580,"Defiance, OH",38160,Micropolitan Statistical Area,Latino,13,13,0,No meaningful results,,,,203,11,214
19580,"Defiance, OH",38160,Micropolitan Statistical Area,Native American,0,0,0,No meaningful results,,,,203,11,214
19580,"Defiance, OH",38160,Micropolitan Statistical Area,AAPI,1,1,0,No meaningful results,,,,203,11,214
25700,"Hays, KS",28775,Micropolitan Statistical Area,Black,2,2,0,No meaningful results,,,,82,7,89
25700,"Hays, KS",28775,Micropolitan Statistical Area,Latino,4,3,1,No meaningful results,,,,82,7,89
25700,"Hays, KS",28775,Micropolitan Statistical Area,Native American,2,2,0,No meaningful results,,,,82,7,89
25700,"Hays, KS",28775,Micropolitan Statistical Area,AAPI,0,0,0,No meaningful results,,,,82,7,89
17580,"Clovis, NM",49732,Micropolitan Statistical Area,Black,1,1,0,No meaningful results,,,,86,4,90
17580,"Clovis, NM",49732,Micropolitan Statistical Area,Latino,39,37,2,No meaningful results,,,,86,4,90
17580,"Clovis, NM",49732,Micropolitan Statistical Area,Native American,0,0,0,No meaningful results,,,,86,4,90
17580,"Clovis, NM",49732,Micropolitan Statistical Area,AAPI,1,1,0,No meaningful results,,,,86,4,90
45900,"Traverse City, MI",149033,Micropolitan Statistical Area,Black,1,1,0,No meaningful results,,,,1091,64,1155
45900,"Traverse City, MI",149033,Micropolitan Statistical Area,Latino,10,9,1,No meaningful results,,,,1091,64,1155
45900,"Traverse City, MI",149033,Micropolitan Statistical Area,Native American,4,4,0,No meaningful results,,,,1091,64,1155
45900,"Traverse City, MI",149033,Micropolitan Statistical Area,AAPI,14,13,1,No meaningful results,,,,1091,64,1155
31060,"Los Alamos, NM",18625,Micropolitan Statistical Area,Black,1,1,0,No meaningful results,,,,205,5,210
31060,"Los Alamos, NM",18625,Micropolitan Statistical Area,Latino,23,22,1,No meaningful results,,,,205,5,210
31060,"Los Alamos, NM",18625,Micropolitan Statistical Area,Native American,0,0,0,No meaningful results,,,,205,5,210
31060,"Los Alamos, NM",18625,Micropolitan Statistical Area,AAPI,18,18,0,No meaningful results,,,,205,5,210
15220,"Brownwood, TX",37855,Micropolitan Statistical Area,Black,2,2,0,No meaningful results,,,,80,5,85
15220,"Brownwood, TX",37855,Micropolitan Statistical Area,Latino,11,10,1,No meaningful results,,,,80,5,85
15220,"Brownwood, TX",37855,Micropolitan Statistical Area,Native American,0,0,0,No meaningful results,,,,80,5,85
15220,"Brownwood, TX",37855,Micropolitan Statistical Area,AAPI,0,0,0,No meaningful results,,,,80,5,85
45340,"Taos, NM",32786,Micropolitan Statistical Area,Black,0,0,0,No meaningful results,,,,70,9,79
45340,"Taos, NM",32786,Micropolitan Statistical Area,Latino,13,13,0,No meaningful results,,,,70,9,79
45340,"Taos, NM",32786,Micropolitan Statistical Area,Native American,1,1,0,No meaningful results,,,,70,9,79
45340,"Taos, NM",32786,Micropolitan Statistical Area,AAPI,1,1,0,No meaningful results,,,,70,9,79
29780,"Las Vegas, NM",32274,Micropolitan Statistical Area,Black,0,0,0,No meaningful results,,,,21,1,22
29780,"Las Vegas, NM",32274,Micropolitan Statistical Area,Latino,23,18,5,No meaningful results,,,,21,1,22
29780,"Las Vegas, NM",32274,Micropolitan Statistical Area,Native American,0,0,0,No meaningful results,,,,21,1,22
29780,"Las Vegas, NM",32274,Micropolitan Statistical Area,AAPI,0,0,0,No meaningful results,,,,21,1,22
34340,"Mount Airy, NC",71971,Micropolitan Statistical Area,Black,2,0,2,No meaningful results,,,,252,29,281
34340,"Mount Airy, NC",71971,Micropolitan Statistical Area,Latino,23,21,2,No meaningful results,,,,252,29,281
34340,"Mount Airy, NC",71971,Micropolitan Statistical Area,Native American,2,2,0,No meaningful results,,,,252,29,281
34340,"Mount Airy, NC",71971,Micropolitan Statistical Area,AAPI,5,4,1,No meaningful results,,,,252,29,281
49780,"Zanesville, OH",86131,Micropolitan Statistical Area,Black,9,8,1,No meaningful results,,,,421,31,452
49780,"Zanesville, OH",86131,Micropolitan Statistical Area,Latino,5,4,1,No meaningful results,,,,421,31,452
49780,"Zanesville, OH",86131,Micropolitan Statistical Area,Native American,0,0,0,No meaningful results,,,,421,31,452
49780,"Zanesville, OH",86131,Micropolitan Statistical Area,AAPI,2,2,0,No meaningful results,,,,421,31,452
30580,"Liberal, KS",22349,Micropolitan Statistical Area,Black,0,0,0,No meaningful results,,,,23,3,26
30580,"Liberal, KS",22349,Micropolitan Statistical Area,Latino,27,20,7,No meaningful results,,,,23,3,26
30580,"Liberal, KS",22349,Micropolitan Statistical Area,Native American,0,0,0,No meaningful results,,,,23,3,26
30580,"Liberal, KS",22349,Micropolitan Statistical Area,AAPI,0,0,0,No meaningful results,,,,23,3,26
29700,"Laredo, TX",273526,Metropolitan Statistical Area,Black,0,0,0,No meaningful results,,,,33,2,35
29700,"Laredo, TX",273526,Metropolitan Statistical Area,Latino,582,528,54,No meaningful results,,,,33,2,35
29700,"Laredo, TX",273526,Metropolitan Statistical Area,Native American,0,0,0,No meaningful results,,,,33,2,35
29700,"Laredo, TX",273526,Metropolitan Statistical Area,AAPI,7,6,1,No meaningful results,,,,33,2,35
23620,"Gainesville, TX",40041,Micropolitan Statistical Area,Black,0,0,0,No meaningful results,,,,201,12,213
23620,"Gainesville, TX",40041,Micropolitan Statistical Area,Latino,21,18,3,No meaningful results,,,,201,12,213
23620,"Gainesville, TX",40041,Micropolitan Statistical Area,Native American,1,1,0,No meaningful results,,,,201,12,213
23620,"Gainesville, TX",40041,Micropolitan Statistical Area,AAPI,2,2,0,No meaningful results,,,,201,12,213
29060,"Laconia, NH",60887,Micropolitan Statistical Area,Black,3,3,0,No meaningful results,,,,462,40,502
29060,"Laconia, NH",60887,Micropolitan Statistical Area,Latino,8,7,1,No meaningful results,,,,462,40,502
29060,"Laconia, NH",60887,Micropolitan Statistical Area,Native American,1,1,0,No meaningful results,,,,462,40,502
29060,"Laconia, NH",60887,Micropolitan Statistical Area,AAPI,6,3,3,No meaningful results,,,,462,40,502
47240,"Vineyard Haven, MA",17312,Micropolitan Statistical Area,Black,2,1,1,No meaningful results,,,,86,2,88
47240,"Vineyard Haven, MA",17312,Micropolitan Statistical Area,Latino,6,5,1,No meaningful results,,,,86,2,88
47240,"Vineyard Haven, MA",17312,Micropolitan Statistical Area,Native American,0,0,0,No meaningful results,,,,86,2,88
47240,"Vineyard Haven, MA",17312,Micropolitan Statistical Area,AAPI,0,0,0,No meaningful results,,,,86,2,88
48700,"Williamsport, PA",114330,Metropolitan Statistical Area,Black,6,5,1,No meaningful results,,,,478,31,509
48700,"Williamsport, PA",114330,Metropolitan Statistical Area,Latino,11,10,1,No meaningful results,,,,478,31,509
48700,"Williamsport, PA",114330,Metropolitan Statistical Area,Native American,2,1,1,No meaningful results,,,,478,31,509
48700,"Williamsport, PA",114330,Metropolitan Statistical Area,AAPI,7,7,0,No meaningful results,,,,478,31,509
23700,"Gallup, NM",72438,Micropolitan Statistical Area,Black,2,0,2,No meaningful results,,,,29,7,36
23700,"Gallup, NM",72438,Micropolitan Statistical Area,Latino,7,5,2,No meaningful results,,,,29,7,36
23700,"Gallup, NM",72438,Micropolitan Statistical Area,Native American,7,6,1,No meaningful results,,,,29,7,36
23700,"Gallup, NM",72438,Micropolitan Statistical Area,AAPI,3,3,0,No meaningful results,,,,29,7,36
39940,"Rexburg, ID",52120,Micropolitan Statistical Area,Black,0,0,0,No meaningful results,,,,192,16,208
39940,"Rexburg, ID",52120,Micropolitan Statistical Area,Latino,11,8,3,No meaningful results,,,,192,16,208
39940,"Rexburg, ID",52120,Micropolitan Statistical Area,Native American,1,1,0,No meaningful results,,,,192,16,208
39940,"Rexburg, ID",52120,Micropolitan Statistical Area,AAPI,6,6,0,No meaningful results,,,,192,16,208
20180,"DuBois, PA",79908,Micropolitan Statistical Area,Black,2,2,0,No meaningful results,,,,309,25,334
20180,"DuBois, PA",79908,Micropolitan Statistical Area,Latino,3,3,0,No meaningful results,,,,309,25,334
20180,"DuBois, PA",79908,Micropolitan Statistical Area,Native American,0,0,0,No meaningful results,,,,309,25,334
20180,"DuBois, PA",79908,Micropolitan Statistical Area,AAPI,7,5,2,No meaningful results,,,,309,25,334
20460,"Durant, OK",46457,Micropolitan Statistical Area,Black,2,2,0,No meaningful results,,,,126,2,128
20460,"Durant, OK",46457,Micropolitan Statistical Area,Latino,9,6,3,No meaningful results,,,,126,2,128
20460,"Durant, OK",46457,Micropolitan Statistical Area,Native American,22,22,0,No meaningful results,,,,126,2,128
20460,"Durant, OK",46457,Micropolitan Statistical Area,AAPI,4,4,0,No meaningful results,,,,126,2,128
13060,"Bay City, TX",36774,Micropolitan Statistical Area,Black,5,5,0,No meaningful results,,,,74,2,76
13060,"Bay City, TX",36774,Micropolitan Statistical Area,Latino,38,36,2,No meaningful results,,,,74,2,76
13060,"Bay City, TX",36774,Micropolitan Statistical Area,Native American,0,0,0,No meaningful results,,,,74,2,76
13060,"Bay City, TX",36774,Micropolitan Statistical Area,AAPI,1,1,0,No meaningful results,,,,74,2,76
28300,"Keene, NH",76042,Micropolitan Statistical Area,Black,1,1,0,No meaningful results,,,,344,17,361
28300,"Keene, NH",76042,Micropolitan Statistical Area,Latino,5,4,1,No meaningful results,,,,344,17,361
28300,"Keene, NH",76042,Micropolitan Statistical Area,Native American,0,0,0,No meaningful results,,,,344,17,361
28300,"Keene, NH",76042,Micropolitan Statistical Area,AAPI,9,9,0,No meaningful results,,,,344,17,361
11940,"Athens, TN",53053,Micropolitan Statistical Area,Black,2,2,0,No meaningful results,,,,131,16,147
11940,"Athens, TN",53053,Micropolitan Statistical Area,Latino,2,2,0,No meaningful results,,,,131,16,147
11940,"Athens, TN",53053,Micropolitan Statistical Area,Native American,1,1,0,No meaningful results,,,,131,16,147
11940,"Athens, TN",53053,Micropolitan Statistical Area,AAPI,3,2,1,No meaningful results,,,,131,16,147
19420,"Dayton, TN",32719,Micropolitan Statistical Area,Black,0,0,0,No meaningful results,,,,88,8,96
19420,"Dayton, TN",32719,Micropolitan Statistical Area,Latino,1,1,0,No meaningful results,,,,88,8,96
19420,"Dayton, TN",32719,Micropolitan Statistical Area,Native American,0,0,0,No meaningful results,,,,88,8,96
19420,"Dayton, TN",32719,Micropolitan Statistical Area,AAPI,0,0,0,No meaningful results,,,,88,8,96
26580,"Huntington-Ashland, WV-KY-OH",361832,Metropolitan Statistical Area,Black,18,14,4,No meaningful results,,,,1365,114,1479
26580,"Huntington-Ashland, WV-KY-OH",361832,Metropolitan Statistical Area,Latino,17,16,1,No meaningful results,,,,1365,114,1479
26580,"Huntington-Ashland, WV-KY-OH",361832,Metropolitan Statistical Area,Native American,1,1,0,No meaningful results,,,,1365,114,1479
26580,"Huntington-Ashland, WV-KY-OH",361832,Metropolitan Statistical Area,AAPI,16,16,0,No meaningful results,,,,1365,114,1479
15740,"Cambridge, OH",39111,Micropolitan Statistical Area,Black,1,1,0,No meaningful results,,,,151,14,165
15740,"Cambridge, OH",39111,Micropolitan Statistical Area,Latino,1,1,0,No meaningful results,,,,151,14,165
15740,"Cambridge, OH",39111,Micropolitan Statistical Area,Native American,1,0,1,No meaningful results,,,,151,14,165
15740,"Cambridge, OH",39111,Micropolitan Statistical Area,AAPI,0,0,0,No meaningful results,,,,151,14,165
16620,"Charleston, WV",264113,Metropolitan Statistical Area,Black,21,17,4,Regression equation needs to be tweaked,3.03965264,3,30,731,62,793
16620,"Charleston, WV",264113,Metropolitan Statistical Area,Latino,10,9,1,Regression equation needs to be tweaked,1.707873177,1.7,17,731,62,793
16620,"Charleston, WV",264113,Metropolitan Statistical Area,Native American,1,1,0,Regression equation needs to be tweaked,7.91E-08,0,0,731,62,793
16620,"Charleston, WV",264113,Metropolitan Statistical Area,AAPI,13,13,0,Regression equation needs to be tweaked,1.73E-07,0,0,731,62,793
34060,"Morgantown, WV",139157,Metropolitan Statistical Area,Black,12,12,0,No meaningful results,,,,683,49,732
34060,"Morgantown, WV",139157,Metropolitan Statistical Area,Latino,13,13,0,No meaningful results,,,,683,49,732
34060,"Morgantown, WV",139157,Metropolitan Statistical Area,Native American,1,1,0,No meaningful results,,,,683,49,732
34060,"Morgantown, WV",139157,Metropolitan Statistical Area,AAPI,42,36,6,No meaningful results,,,,683,49,732
25580,"Hastings, NE",31587,Micropolitan Statistical Area,Black,0,0,0,No meaningful results,,,,147,7,154
25580,"Hastings, NE",31587,Micropolitan Statistical Area,Latino,4,4,0,No meaningful results,,,,147,7,154
25580,"Hastings, NE",31587,Micropolitan Statistical Area,Native American,0,0,0,No meaningful results,,,,147,7,154
25580,"Hastings, NE",31587,Micropolitan Statistical Area,AAPI,1,1,0,No meaningful results,,,,147,7,154
45620,"Thomasville, GA",44630,Micropolitan Statistical Area,Black,9,8,1,No meaningful results,,,,108,4,112
45620,"Thomasville, GA",44630,Micropolitan Statistical Area,Latino,4,4,0,No meaningful results,,,,108,4,112
45620,"Thomasville, GA",44630,Micropolitan Statistical Area,Native American,1,1,0,No meaningful results,,,,108,4,112
45620,"Thomasville, GA",44630,Micropolitan Statistical Area,AAPI,4,4,0,No meaningful results,,,,108,4,112
32660,"McMinnville, TN",40702,Micropolitan Statistical Area,Black,2,2,0,No meaningful results,,,,112,2,114
32660,"McMinnville, TN",40702,Micropolitan Statistical Area,Latino,12,11,1,No meaningful results,,,,112,2,114
32660,"McMinnville, TN",40702,Micropolitan Statistical Area,Native American,1,1,0,No meaningful results,,,,112,2,114
32660,"McMinnville, TN",40702,Micropolitan Statistical Area,AAPI,2,1,1,No meaningful results,,,,112,2,114
20020,"Dothan, AL",148252,Metropolitan Statistical Area,Black,46,40,6,No meaningful results,,,,565,22,587
20020,"Dothan, AL",148252,Metropolitan Statistical Area,Latino,20,19,1,No meaningful results,,,,565,22,587
20020,"Dothan, AL",148252,Metropolitan Statistical Area,Native American,0,0,0,No meaningful results,,,,565,22,587
20020,"Dothan, AL",148252,Metropolitan Statistical Area,AAPI,12,11,1,No meaningful results,,,,565,22,587
18060,"Columbus, MS",59150,Micropolitan Statistical Area,Black,25,25,0,No meaningful results,,,,104,9,113
18060,"Columbus, MS",59150,Micropolitan Statistical Area,Latino,1,1,0,No meaningful results,,,,104,9,113
18060,"Columbus, MS",59150,Micropolitan Statistical Area,Native American,1,1,0,No meaningful results,,,,104,9,113
18060,"Columbus, MS",59150,Micropolitan Statistical Area,AAPI,4,3,1,No meaningful results,,,,104,9,113
41220,"St. Marys, GA",53231,Micropolitan Statistical Area,Black,7,7,0,No meaningful results,,,,177,12,189
41220,"St. Marys, GA",53231,Micropolitan Statistical Area,Latino,6,5,1,No meaningful results,,,,177,12,189
41220,"St. Marys, GA",53231,Micropolitan Statistical Area,Native American,0,0,0,No meaningful results,,,,177,12,189
41220,"St. Marys, GA",53231,Micropolitan Statistical Area,AAPI,8,8,0,No meaningful results,,,,177,12,189
43700,"Somerset, KY",64350,Micropolitan Statistical Area,Black,3,3,0,No meaningful results,,,,118,6,124
43700,"Somerset, KY",64350,Micropolitan Statistical Area,Latino,5,4,1,No meaningful results,,,,118,6,124
43700,"Somerset, KY",64350,Micropolitan Statistical Area,Native American,1,1,0,No meaningful results,,,,118,6,124
43700,"Somerset, KY",64350,Micropolitan Statistical Area,AAPI,0,0,0,No meaningful results,,,,118,6,124
19140,"Dalton, GA",143961,Metropolitan Statistical Area,Black,4,4,0,No meaningful results,,,,330,28,358
19140,"Dalton, GA",143961,Metropolitan Statistical Area,Latino,153,138,15,No meaningful results,,,,330,28,358
19140,"Dalton, GA",143961,Metropolitan Statistical Area,Native American,0,0,0,No meaningful results,,,,330,28,358
19140,"Dalton, GA",143961,Metropolitan Statistical Area,AAPI,17,12,5,No meaningful results,,,,330,28,358
46180,"Tupelo, MS",165407,Micropolitan Statistical Area,Black,47,41,6,Regression equation needs to be tweaked,1.643446674,1.6,16,508,37,545
46180,"Tupelo, MS",165407,Micropolitan Statistical Area,Latino,12,10,2,Regression equation needs to be tweaked,1.482325501,1.5,15,508,37,545
46180,"Tupelo, MS",165407,Micropolitan Statistical Area,Native American,2,2,0,Regression equation needs to be tweaked,2.41E-14,0,0,508,37,545
46180,"Tupelo, MS",165407,Micropolitan Statistical Area,AAPI,10,8,2,Regression equation needs to be tweaked,3.282396877,3.3,33,508,37,545
13980,"Blacksburg-Christiansburg, VA",166785,Metropolitan Statistical Area,Black,11,11,0,No meaningful results,,,,685,29,714
13980,"Blacksburg-Christiansburg, VA",166785,Metropolitan Statistical Area,Latino,22,21,1,No meaningful results,,,,685,29,714
13980,"Blacksburg-Christiansburg, VA",166785,Metropolitan Statistical Area,Native American,1,1,0,No meaningful results,,,,685,29,714
13980,"Blacksburg-Christiansburg, VA",166785,Metropolitan Statistical Area,AAPI,29,28,1,No meaningful results,,,,685,29,714
30940,"London, KY",148221,Micropolitan Statistical Area,Black,3,3,0,No meaningful results,,,,277,21,298
30940,"London, KY",148221,Micropolitan Statistical Area,Latino,3,2,1,No meaningful results,,,,277,21,298
30940,"London, KY",148221,Micropolitan Statistical Area,Native American,1,1,0,No meaningful results,,,,277,21,298
30940,"London, KY",148221,Micropolitan Statistical Area,AAPI,1,1,0,No meaningful results,,,,277,21,298
42460,"Scottsboro, AL",51852,Micropolitan Statistical Area,Black,3,3,0,No meaningful results,,,,119,6,125
42460,"Scottsboro, AL",51852,Micropolitan Statistical Area,Latino,1,1,0,No meaningful results,,,,119,6,125
42460,"Scottsboro, AL",51852,Micropolitan Statistical Area,Native American,1,1,0,No meaningful results,,,,119,6,125
42460,"Scottsboro, AL",51852,Micropolitan Statistical Area,AAPI,0,0,0,No meaningful results,,,,119,6,125
44900,"Summerville, GA",24812,Micropolitan Statistical Area,Black,4,4,0,No meaningful results,,,,43,5,48
44900,"Summerville, GA",24812,Micropolitan Statistical Area,Latino,1,1,0,No meaningful results,,,,43,5,48
44900,"Summerville, GA",24812,Micropolitan Statistical Area,Native American,0,0,0,No meaningful results,,,,43,5,48
44900,"Summerville, GA",24812,Micropolitan Statistical Area,AAPI,0,0,0,No meaningful results,,,,43,5,48
12460,"Bainbridge, GA",26682,Micropolitan Statistical Area,Black,9,5,4,No meaningful results,,,,32,4,36
12460,"Bainbridge, GA",26682,Micropolitan Statistical Area,Latino,0,0,0,No meaningful results,,,,32,4,36
12460,"Bainbridge, GA",26682,Micropolitan Statistical Area,Native American,0,0,0,No meaningful results,,,,32,4,36
12460,"Bainbridge, GA",26682,Micropolitan Statistical Area,AAPI,0,0,0,No meaningful results,,,,32,4,36
35260,"New Castle, PA",86727,Micropolitan Statistical Area,Black,2,2,0,No meaningful results,,,,315,20,335
35260,"New Castle, PA",86727,Micropolitan Statistical Area,Latino,3,2,1,No meaningful results,,,,315,20,335
35260,"New Castle, PA",86727,Micropolitan Statistical Area,Native American,0,0,0,No meaningful results,,,,315,20,335
35260,"New Castle, PA",86727,Micropolitan Statistical Area,AAPI,3,3,0,No meaningful results,,,,315,20,335
10700,"Albertville, AL",95643,Micropolitan Statistical Area,Black,4,4,0,No meaningful results,,,,305,16,321
10700,"Albertville, AL",95643,Micropolitan Statistical Area,Latino,19,18,1,No meaningful results,,,,305,16,321
10700,"Albertville, AL",95643,Micropolitan Statistical Area,Native American,5,5,0,No meaningful results,,,,305,16,321
10700,"Albertville, AL",95643,Micropolitan Statistical Area,AAPI,2,2,0,No meaningful results,,,,305,16,321
45460,"Terre Haute, IN",186908,Metropolitan Statistical Area,Black,8,8,0,Regression equation needs to be tweaked,2.82E-09,0,0,768,61,829
45460,"Terre Haute, IN",186908,Metropolitan Statistical Area,Latino,11,10,1,Regression equation needs to be tweaked,0.77093833,0.8,8,768,61,829
45460,"Terre Haute, IN",186908,Metropolitan Statistical Area,Native American,0,0,0,Regression equation needs to be tweaked,119.8252444,119.8,1198,768,61,829
45460,"Terre Haute, IN",186908,Metropolitan Statistical Area,AAPI,18,16,2,Regression equation needs to be tweaked,1.785451794,1.8,18,768,61,829
22520,"Florence-Muscle Shoals, AL",147327,Metropolitan Statistical Area,Black,24,22,2,No meaningful results,,,,736,40,776
22520,"Florence-Muscle Shoals, AL",147327,Metropolitan Statistical Area,Latino,17,16,1,No meaningful results,,,,736,40,776
22520,"Florence-Muscle Shoals, AL",147327,Metropolitan Statistical Area,Native American,4,3,1,No meaningful results,,,,736,40,776
22520,"Florence-Muscle Shoals, AL",147327,Metropolitan Statistical Area,AAPI,7,7,0,No meaningful results,,,,736,40,776
44260,"Starkville, MS",59280,Micropolitan Statistical Area,Black,11,10,1,No meaningful results,,,,221,6,227
44260,"Starkville, MS",59280,Micropolitan Statistical Area,Latino,4,4,0,No meaningful results,,,,221,6,227
44260,"Starkville, MS",59280,Micropolitan Statistical Area,Native American,0,0,0,No meaningful results,,,,221,6,227
44260,"Starkville, MS",59280,Micropolitan Statistical Area,AAPI,23,21,2,No meaningful results,,,,221,6,227
11500,"Anniston-Oxford, AL",114618,Metropolitan Statistical Area,Black,27,22,5,No meaningful results,,,,280,17,297
11500,"Anniston-Oxford, AL",114618,Metropolitan Statistical Area,Latino,6,5,1,No meaningful results,,,,280,17,297
11500,"Anniston-Oxford, AL",114618,Metropolitan Statistical Area,Native American,0,0,0,No meaningful results,,,,280,17,297
11500,"Anniston-Oxford, AL",114618,Metropolitan Statistical Area,AAPI,5,5,0,No meaningful results,,,,280,17,297
39700,"Raymondville, TX",21588,Micropolitan Statistical Area,Black,0,0,0,No meaningful results,,,,6,1,7
39700,"Raymondville, TX",21588,Micropolitan Statistical Area,Latino,10,6,4,No meaningful results,,,,6,1,7
39700,"Raymondville, TX",21588,Micropolitan Statistical Area,Native American,0,0,0,No meaningful results,,,,6,1,7
39700,"Raymondville, TX",21588,Micropolitan Statistical Area,AAPI,0,0,0,No meaningful results,,,,6,1,7
46980,"Vicksburg, MS",46519,Micropolitan Statistical Area,Black,18,16,2,No meaningful results,,,,81,2,83
46980,"Vicksburg, MS",46519,Micropolitan Statistical Area,Latino,0,0,0,No meaningful results,,,,81,2,83
46980,"Vicksburg, MS",46519,Micropolitan Statistical Area,Native American,1,0,1,No meaningful results,,,,81,2,83
46980,"Vicksburg, MS",46519,Micropolitan Statistical Area,AAPI,3,2,1,No meaningful results,,,,81,2,83
45980,"Troy, AL",33333,Micropolitan Statistical Area,Black,9,7,2,No meaningful results,,,,94,5,99
45980,"Troy, AL",33333,Micropolitan Statistical Area,Latino,1,1,0,No meaningful results,,,,94,5,99
45980,"Troy, AL",33333,Micropolitan Statistical Area,Native American,0,0,0,No meaningful results,,,,94,5,99
45980,"Troy, AL",33333,Micropolitan Statistical Area,AAPI,6,6,0,No meaningful results,,,,94,5,99
16420,"Central City, KY",30951,Micropolitan Statistical Area,Black,1,1,0,No meaningful results,,,,60,4,64
16420,"Central City, KY",30951,Micropolitan Statistical Area,Latino,1,1,0,No meaningful results,,,,60,4,64
16420,"Central City, KY",30951,Micropolitan Statistical Area,Native American,0,0,0,No meaningful results,,,,60,4,64
16420,"Central City, KY",30951,Micropolitan Statistical Area,AAPI,0,0,0,No meaningful results,,,,60,4,64
29340,"Lake Charles, LA",208549,Metropolitan Statistical Area,Black,85,73,12,Regression equation needs to be tweaked,2.79784013,2.8,28,815,55,870
29340,"Lake Charles, LA",208549,Metropolitan Statistical Area,Latino,33,26,7,Regression equation needs to be tweaked,4.607360817,4.6,46,815,55,870
29340,"Lake Charles, LA",208549,Metropolitan Statistical Area,Native American,3,3,0,Regression equation needs to be tweaked,1.38E-09,0,0,815,55,870
29340,"Lake Charles, LA",208549,Metropolitan Statistical Area,AAPI,23,22,1,Regression equation needs to be tweaked,1.982904152,2,20,815,55,870
25620,"Hattiesburg, MS",168177,Metropolitan Statistical Area,Black,51,47,4,Regression equation needs to be tweaked,0.315969328,0.3,3,509,33,542
25620,"Hattiesburg, MS",168177,Metropolitan Statistical Area,Latino,13,11,2,Regression equation needs to be tweaked,0.991285731,1,10,509,33,542
25620,"Hattiesburg, MS",168177,Metropolitan Statistical Area,Native American,1,1,0,Regression equation needs to be tweaked,1.01E-09,0,0,509,33,542
25620,"Hattiesburg, MS",168177,Metropolitan Statistical Area,AAPI,11,8,3,Regression equation needs to be tweaked,23.72329672,23.7,237,509,33,542
29020,"Kokomo, IN",82331,Metropolitan Statistical Area,Black,10,9,1,Regression equation needs to be tweaked,4.799319267,4.8,48,435,26,461
29020,"Kokomo, IN",82331,Metropolitan Statistical Area,Latino,8,7,1,Regression equation needs to be tweaked,0.324927609,0.3,3,435,26,461
29020,"Kokomo, IN",82331,Metropolitan Statistical Area,Native American,1,1,0,Regression equation needs to be tweaked,4.48E-07,0,0,435,26,461
29020,"Kokomo, IN",82331,Metropolitan Statistical Area,AAPI,7,6,1,Regression equation needs to be tweaked,9.054024112,9.1,91,435,26,461
36300,"Ogdensburg-Massena, NY",108913,Micropolitan Statistical Area,Black,1,1,0,No meaningful results,,,,237,33,270
36300,"Ogdensburg-Massena, NY",108913,Micropolitan Statistical Area,Latino,2,2,0,No meaningful results,,,,237,33,270
36300,"Ogdensburg-Massena, NY",108913,Micropolitan Statistical Area,Native American,0,0,0,No meaningful results,,,,237,33,270
36300,"Ogdensburg-Massena, NY",108913,Micropolitan Statistical Area,AAPI,5,4,1,No meaningful results,,,,237,33,270
15500,"Burlington, NC",163324,Metropolitan Statistical Area,Black,138,127,11,No meaningful results,,,,886,39,925
15500,"Burlington, NC",163324,Metropolitan Statistical Area,Latino,142,126,16,No meaningful results,,,,886,39,925
15500,"Burlington, NC",163324,Metropolitan Statistical Area,Native American,5,5,0,No meaningful results,,,,886,39,925
15500,"Burlington, NC",163324,Metropolitan Statistical Area,AAPI,40,36,4,No meaningful results,,,,886,39,925
44780,"Sturgis, MI",60836,Micropolitan Statistical Area,Black,2,2,0,No meaningful results,,,,225,19,244
44780,"Sturgis, MI",60836,Micropolitan Statistical Area,Latino,7,7,0,No meaningful results,,,,225,19,244
44780,"Sturgis, MI",60836,Micropolitan Statistical Area,Native American,1,1,0,No meaningful results,,,,225,19,244
44780,"Sturgis, MI",60836,Micropolitan Statistical Area,AAPI,2,2,0,No meaningful results,,,,225,19,244
15380,"Buffalo-Cheektowaga, NY",1130175,Metropolitan Statistical Area,Black,284,249,35,Regression equation needs to be tweaked,1.87782191,1.9,19,5766,267,6033
15380,"Buffalo-Cheektowaga, NY",1130175,Metropolitan Statistical Area,Latino,158,150,8,Regression equation needs to be tweaked,0.639459212,0.6,6,5766,267,6033
15380,"Buffalo-Cheektowaga, NY",1130175,Metropolitan Statistical Area,Native American,26,24,2,Regression equation needs to be tweaked,0.71222487,0.7,7,5766,267,6033
15380,"Buffalo-Cheektowaga, NY",1130175,Metropolitan Statistical Area,AAPI,402,344,58,Regression equation needs to be tweaked,2.049806979,2,20,5766,267,6033
34660,"Murray, KY",38837,Micropolitan Statistical Area,Black,2,2,0,No meaningful results,,,,137,9,146
34660,"Murray, KY",38837,Micropolitan Statistical Area,Latino,2,2,0,No meaningful results,,,,137,9,146
34660,"Murray, KY",38837,Micropolitan Statistical Area,Native American,0,0,0,No meaningful results,,,,137,9,146
34660,"Murray, KY",38837,Micropolitan Statistical Area,AAPI,3,3,0,No meaningful results,,,,137,9,146
48060,"Watertown-Fort Drum, NY",112842,Metropolitan Statistical Area,Black,4,3,1,No meaningful results,,,,306,17,323
48060,"Watertown-Fort Drum, NY",112842,Metropolitan Statistical Area,Latino,8,6,2,No meaningful results,,,,306,17,323
48060,"Watertown-Fort Drum, NY",112842,Metropolitan Statistical Area,Native American,0,0,0,No meaningful results,,,,306,17,323
48060,"Watertown-Fort Drum, NY",112842,Metropolitan Statistical Area,AAPI,5,5,0,No meaningful results,,,,306,17,323
16340,"Cedartown, GA",41908,Micropolitan Statistical Area,Black,6,4,2,No meaningful results,,,,78,9,87
16340,"Cedartown, GA",41908,Micropolitan Statistical Area,Latino,5,2,3,No meaningful results,,,,78,9,87
16340,"Cedartown, GA",41908,Micropolitan Statistical Area,Native American,0,0,0,No meaningful results,,,,78,9,87
16340,"Cedartown, GA",41908,Micropolitan Statistical Area,AAPI,2,1,1,No meaningful results,,,,78,9,87
18380,"Cordele, GA",22713,Micropolitan Statistical Area,Black,2,2,0,No meaningful results,,,,37,3,40
18380,"Cordele, GA",22713,Micropolitan Statistical Area,Latino,2,2,0,No meaningful results,,,,37,3,40
18380,"Cordele, GA",22713,Micropolitan Statistical Area,Native American,0,0,0,No meaningful results,,,,37,3,40
18380,"Cordele, GA",22713,Micropolitan Statistical Area,AAPI,1,1,0,No meaningful results,,,,37,3,40
42420,"Scottsbluff, NE",38015,Micropolitan Statistical Area,Black,1,1,0,No meaningful results,,,,69,8,77
42420,"Scottsbluff, NE",38015,Micropolitan Statistical Area,Latino,7,6,1,No meaningful results,,,,69,8,77
42420,"Scottsbluff, NE",38015,Micropolitan Statistical Area,Native American,1,1,0,No meaningful results,,,,69,8,77
42420,"Scottsbluff, NE",38015,Micropolitan Statistical Area,AAPI,1,1,0,No meaningful results,,,,69,8,77
15100,"Brookings, SD",34601,Micropolitan Statistical Area,Black,1,1,0,No meaningful results,,,,204,5,209
15100,"Brookings, SD",34601,Micropolitan Statistical Area,Latino,6,4,2,No meaningful results,,,,204,5,209
15100,"Brookings, SD",34601,Micropolitan Statistical Area,Native American,0,0,0,No meaningful results,,,,204,5,209
15100,"Brookings, SD",34601,Micropolitan Statistical Area,AAPI,3,3,0,No meaningful results,,,,204,5,209
38780,"Portales, NM",18888,Micropolitan Statistical Area,Black,1,1,0,No meaningful results,,,,18,1,19
38780,"Portales, NM",18888,Micropolitan Statistical Area,Latino,10,8,2,No meaningful results,,,,18,1,19
38780,"Portales, NM",18888,Micropolitan Statistical Area,Native American,0,0,0,No meaningful results,,,,18,1,19
38780,"Portales, NM",18888,Micropolitan Statistical Area,AAPI,1,1,0,No meaningful results,,,,18,1,19
36340,"Oil City, PA",51818,Micropolitan Statistical Area,Black,1,1,0,No meaningful results,,,,125,17,142
36340,"Oil City, PA",51818,Micropolitan Statistical Area,Latino,3,2,1,No meaningful results,,,,125,17,142
36340,"Oil City, PA",51818,Micropolitan Statistical Area,Native American,1,0,1,No meaningful results,,,,125,17,142
36340,"Oil City, PA",51818,Micropolitan Statistical Area,AAPI,2,2,0,No meaningful results,,,,125,17,142
31340,"Lynchburg, VA",261652,Metropolitan Statistical Area,Black,52,48,4,No meaningful results,,,,1304,67,1371
31340,"Lynchburg, VA",261652,Metropolitan Statistical Area,Latino,26,24,2,No meaningful results,,,,1304,67,1371
31340,"Lynchburg, VA",261652,Metropolitan Statistical Area,Native American,1,1,0,No meaningful results,,,,1304,67,1371
31340,"Lynchburg, VA",261652,Metropolitan Statistical Area,AAPI,22,21,1,No meaningful results,,,,1304,67,1371
45700,"Tifton, GA",40541,Micropolitan Statistical Area,Black,9,8,1,No meaningful results,,,,94,6,100
45700,"Tifton, GA",40541,Micropolitan Statistical Area,Latino,3,1,2,No meaningful results,,,,94,6,100
45700,"Tifton, GA",40541,Micropolitan Statistical Area,Native American,0,0,0,No meaningful results,,,,94,6,100
45700,"Tifton, GA",40541,Micropolitan Statistical Area,AAPI,6,6,0,No meaningful results,,,,94,6,100
35420,"New Philadelphia-Dover, OH",92335,Micropolitan Statistical Area,Black,1,1,0,No meaningful results,,,,276,14,290
35420,"New Philadelphia-Dover, OH",92335,Micropolitan Statistical Area,Latino,5,5,0,No meaningful results,,,,276,14,290
35420,"New Philadelphia-Dover, OH",92335,Micropolitan Statistical Area,Native American,0,0,0,No meaningful results,,,,276,14,290
35420,"New Philadelphia-Dover, OH",92335,Micropolitan Statistical Area,AAPI,0,0,0,No meaningful results,,,,276,14,290
20540,"Dyersburg, TN",37416,Micropolitan Statistical Area,Black,4,4,0,No meaningful results,,,,102,8,110
20540,"Dyersburg, TN",37416,Micropolitan Statistical Area,Latino,1,1,0,No meaningful results,,,,102,8,110
20540,"Dyersburg, TN",37416,Micropolitan Statistical Area,Native American,0,0,0,No meaningful results,,,,102,8,110
20540,"Dyersburg, TN",37416,Micropolitan Statistical Area,AAPI,2,2,0,No meaningful results,,,,102,8,110
49080,"Winnemucca, NV",16828,Micropolitan Statistical Area,Black,1,1,0,No meaningful results,,,,74,4,78
49080,"Winnemucca, NV",16828,Micropolitan Statistical Area,Latino,9,9,0,No meaningful results,,,,74,4,78
49080,"Winnemucca, NV",16828,Micropolitan Statistical Area,Native American,1,1,0,No meaningful results,,,,74,4,78
49080,"Winnemucca, NV",16828,Micropolitan Statistical Area,AAPI,2,2,0,No meaningful results,,,,74,4,78
32100,"Marquette, MI",66686,Micropolitan Statistical Area,Black,1,1,0,No meaningful results,,,,269,19,288
32100,"Marquette, MI",66686,Micropolitan Statistical Area,Latino,1,1,0,No meaningful results,,,,269,19,288
32100,"Marquette, MI",66686,Micropolitan Statistical Area,Native American,4,3,1,No meaningful results,,,,269,19,288
32100,"Marquette, MI",66686,Micropolitan Statistical Area,AAPI,3,3,0,No meaningful results,,,,269,19,288
24500,"Great Falls, MT",81625,Metropolitan Statistical Area,Black,4,3,1,No meaningful results,,,,476,34,510
24500,"Great Falls, MT",81625,Metropolitan Statistical Area,Latino,10,8,2,No meaningful results,,,,476,34,510
24500,"Great Falls, MT",81625,Metropolitan Statistical Area,Native American,3,2,1,No meaningful results,,,,476,34,510
24500,"Great Falls, MT",81625,Metropolitan Statistical Area,AAPI,3,3,0,No meaningful results,,,,476,34,510
37620,"Parkersburg-Vienna, WV",90758,Metropolitan Statistical Area,Black,3,3,0,No meaningful results,,,,319,14,333
37620,"Parkersburg-Vienna, WV",90758,Metropolitan Statistical Area,Latino,5,5,0,No meaningful results,,,,319,14,333
37620,"Parkersburg-Vienna, WV",90758,Metropolitan Statistical Area,Native American,1,1,0,No meaningful results,,,,319,14,333
37620,"Parkersburg-Vienna, WV",90758,Metropolitan Statistical Area,AAPI,6,4,2,No meaningful results,,,,319,14,333
28740,"Kingston, NY",178665,Metropolitan Statistical Area,Black,28,22,6,Regression equation needs to be tweaked,3.3174661,3.3,33,589,46,635
28740,"Kingston, NY",178665,Metropolitan Statistical Area,Latino,50,43,7,Regression equation needs to be tweaked,1.478387648,1.5,15,589,46,635
28740,"Kingston, NY",178665,Metropolitan Statistical Area,Native American,1,1,0,Regression equation needs to be tweaked,0.000479285,0,0,589,46,635
28740,"Kingston, NY",178665,Metropolitan Statistical Area,AAPI,18,16,2,Regression equation needs to be tweaked,0.752844032,0.8,8,589,46,635
12120,"Atmore, AL",37057,Micropolitan Statistical Area,Black,8,7,1,No meaningful results,,,,48,5,53
12120,"Atmore, AL",37057,Micropolitan Statistical Area,Latino,1,0,1,No meaningful results,,,,48,5,53
12120,"Atmore, AL",37057,Micropolitan Statistical Area,Native American,4,3,1,No meaningful results,,,,48,5,53
12120,"Atmore, AL",37057,Micropolitan Statistical Area,AAPI,2,2,0,No meaningful results,,,,48,5,53
21500,"Erie, PA",273835,Metropolitan Statistical Area,Black,40,33,7,No meaningful results,,,,1186,77,1263
21500,"Erie, PA",273835,Metropolitan Statistical Area,Latino,28,26,2,No meaningful results,,,,1186,77,1263
21500,"Erie, PA",273835,Metropolitan Statistical Area,Native American,2,2,0,No meaningful results,,,,1186,77,1263
21500,"Erie, PA",273835,Metropolitan Statistical Area,AAPI,84,72,12,No meaningful results,,,,1186,77,1263
20980,"El Dorado, AR",39449,Micropolitan Statistical Area,Black,10,9,1,No meaningful results,,,,120,6,126
20980,"El Dorado, AR",39449,Micropolitan Statistical Area,Latino,6,5,1,No meaningful results,,,,120,6,126
20980,"El Dorado, AR",39449,Micropolitan Statistical Area,Native American,0,0,0,No meaningful results,,,,120,6,126
20980,"El Dorado, AR",39449,Micropolitan Statistical Area,AAPI,3,3,0,No meaningful results,,,,120,6,126
38220,"Pine Bluff, AR",90865,Metropolitan Statistical Area,Black,32,22,10,No meaningful results,,,,72,3,75
38220,"Pine Bluff, AR",90865,Metropolitan Statistical Area,Latino,3,3,0,No meaningful results,,,,72,3,75
38220,"Pine Bluff, AR",90865,Metropolitan Statistical Area,Native American,0,0,0,No meaningful results,,,,72,3,75
38220,"Pine Bluff, AR",90865,Metropolitan Statistical Area,AAPI,6,6,0,No meaningful results,,,,72,3,75
31680,"Malvern, AR",33597,Micropolitan Statistical Area,Black,3,1,2,No meaningful results,,,,61,11,72
31680,"Malvern, AR",33597,Micropolitan Statistical Area,Latino,2,1,1,No meaningful results,,,,61,11,72
31680,"Malvern, AR",33597,Micropolitan Statistical Area,Native American,1,1,0,No meaningful results,,,,61,11,72
31680,"Malvern, AR",33597,Micropolitan Statistical Area,AAPI,0,0,0,No meaningful results,,,,61,11,72
40820,"Ruston, LA",47246,Micropolitan Statistical Area,Black,12,10,2,No meaningful results,,,,157,9,166
40820,"Ruston, LA",47246,Micropolitan Statistical Area,Latino,6,6,0,No meaningful results,,,,157,9,166
40820,"Ruston, LA",47246,Micropolitan Statistical Area,Native American,0,0,0,No meaningful results,,,,157,9,166
40820,"Ruston, LA",47246,Micropolitan Statistical Area,AAPI,5,5,0,No meaningful results,,,,157,9,166
25760,"Helena-West Helena, AR",18606,Micropolitan Statistical Area,Black,8,7,1,No meaningful results,,,,12,1,13
25760,"Helena-West Helena, AR",18606,Micropolitan Statistical Area,Latino,0,0,0,No meaningful results,,,,12,1,13
25760,"Helena-West Helena, AR",18606,Micropolitan Statistical Area,Native American,0,0,0,No meaningful results,,,,12,1,13
25760,"Helena-West Helena, AR",18606,Micropolitan Statistical Area,AAPI,0,0,0,No meaningful results,,,,12,1,13
37500,"Paragould, AR",44937,Micropolitan Statistical Area,Black,1,1,0,No meaningful results,,,,153,9,162
37500,"Paragould, AR",44937,Micropolitan Statistical Area,Latino,6,6,0,No meaningful results,,,,153,9,162
37500,"Paragould, AR",44937,Micropolitan Statistical Area,Native American,1,1,0,No meaningful results,,,,153,9,162
37500,"Paragould, AR",44937,Micropolitan Statistical Area,AAPI,0,0,0,No meaningful results,,,,153,9,162
14180,"Blytheville, AR",42126,Micropolitan Statistical Area,Black,5,4,1,No meaningful results,,,,59,6,65
14180,"Blytheville, AR",42126,Micropolitan Statistical Area,Latino,5,5,0,No meaningful results,,,,59,6,65
14180,"Blytheville, AR",42126,Micropolitan Statistical Area,Native American,0,0,0,No meaningful results,,,,59,6,65
14180,"Blytheville, AR",42126,Micropolitan Statistical Area,AAPI,1,1,0,No meaningful results,,,,59,6,65
22620,"Forrest City, AR",25900,Micropolitan Statistical Area,Black,4,2,2,No meaningful results,,,,13,1,14
22620,"Forrest City, AR",25900,Micropolitan Statistical Area,Latino,0,0,0,No meaningful results,,,,13,1,14
22620,"Forrest City, AR",25900,Micropolitan Statistical Area,Native American,0,0,0,No meaningful results,,,,13,1,14
22620,"Forrest City, AR",25900,Micropolitan Statistical Area,AAPI,0,0,0,No meaningful results,,,,13,1,14
18860,"Crescent City, CA",27495,Micropolitan Statistical Area,Black,1,1,0,No meaningful results,,,,56,8,64
18860,"Crescent City, CA",27495,Micropolitan Statistical Area,Latino,5,4,1,No meaningful results,,,,56,8,64
18860,"Crescent City, CA",27495,Micropolitan Statistical Area,Native American,3,3,0,No meaningful results,,,,56,8,64
18860,"Crescent City, CA",27495,Micropolitan Statistical Area,AAPI,2,1,1,No meaningful results,,,,56,8,64
38700,"Pontiac, IL",36040,Micropolitan Statistical Area,Black,0,0,0,No meaningful results,,,,62,8,70
38700,"Pontiac, IL",36040,Micropolitan Statistical Area,Latino,5,3,2,No meaningful results,,,,62,8,70
38700,"Pontiac, IL",36040,Micropolitan Statistical Area,Native American,0,0,0,No meaningful results,,,,62,8,70
38700,"Pontiac, IL",36040,Micropolitan Statistical Area,AAPI,0,0,0,No meaningful results,,,,62,8,70
47700,"Warsaw, IN",79035,Micropolitan Statistical Area,Black,3,3,0,Regression equation needs to be tweaked,1.05E-05,0,0,574,22,596
47700,"Warsaw, IN",79035,Micropolitan Statistical Area,Latino,39,35,4,Regression equation needs to be tweaked,4.140509443,4.1,41,574,22,596
47700,"Warsaw, IN",79035,Micropolitan Statistical Area,Native American,1,0,1,Regression equation needs to be tweaked,7089.682734,7089.7,70897,574,22,596
47700,"Warsaw, IN",79035,Micropolitan Statistical Area,AAPI,15,14,1,Regression equation needs to be tweaked,3.152437598,3.2,32,574,22,596
19260,"Danville, VA",102326,Micropolitan Statistical Area,Black,30,26,4,Regression equation needs to be tweaked,0.908241659,0.9,9,176,12,188
19260,"Danville, VA",102326,Micropolitan Statistical Area,Latino,8,6,2,Regression equation needs to be tweaked,4.521439589,4.5,45,176,12,188
19260,"Danville, VA",102326,Micropolitan Statistical Area,Native American,0,0,0,Regression equation needs to be tweaked,1.38E+19,1.38E+19,1.38E+20,176,12,188
19260,"Danville, VA",102326,Micropolitan Statistical Area,AAPI,7,4,3,Regression equation needs to be tweaked,10.02516269,10,100,176,12,188
11380,"Andrews, TX",18036,Micropolitan Statistical Area,Black,0,0,0,No meaningful results,,,,54,4,58
11380,"Andrews, TX",18036,Micropolitan Statistical Area,Latino,27,25,2,No meaningful results,,,,54,4,58
11380,"Andrews, TX",18036,Micropolitan Statistical Area,Native American,0,0,0,No meaningful results,,,,54,4,58
11380,"Andrews, TX",18036,Micropolitan Statistical Area,AAPI,0,0,0,No meaningful results,,,,54,4,58
38620,"Ponca City, OK",44402,Micropolitan Statistical Area,Black,2,2,0,No meaningful results,,,,117,9,126
38620,"Ponca City, OK",44402,Micropolitan Statistical Area,Latino,4,4,0,No meaningful results,,,,117,9,126
38620,"Ponca City, OK",44402,Micropolitan Statistical Area,Native American,8,6,2,No meaningful results,,,,117,9,126
38620,"Ponca City, OK",44402,Micropolitan Statistical Area,AAPI,0,0,0,No meaningful results,,,,117,9,126
19700,"Deming, NM",24083,Micropolitan Statistical Area,Black,2,1,1,No meaningful results,,,,18,1,19
19700,"Deming, NM",24083,Micropolitan Statistical Area,Latino,27,21,6,No meaningful results,,,,18,1,19
19700,"Deming, NM",24083,Micropolitan Statistical Area,Native American,0,0,0,No meaningful results,,,,18,1,19
19700,"Deming, NM",24083,Micropolitan Statistical Area,AAPI,2,1,1,No meaningful results,,,,18,1,19
17700,"Coffeyville, KS",32521,Micropolitan Statistical Area,Black,1,0,1,No meaningful results,,,,64,10,74
17700,"Coffeyville, KS",32521,Micropolitan Statistical Area,Latino,5,2,3,No meaningful results,,,,64,10,74
17700,"Coffeyville, KS",32521,Micropolitan Statistical Area,Native American,1,1,0,No meaningful results,,,,64,10,74
17700,"Coffeyville, KS",32521,Micropolitan Statistical Area,AAPI,2,2,0,No meaningful results,,,,64,10,74
12780,"Bartlesville, OK",51886,Micropolitan Statistical Area,Black,2,2,0,No meaningful results,,,,246,11,257
12780,"Bartlesville, OK",51886,Micropolitan Statistical Area,Latino,22,17,5,No meaningful results,,,,246,11,257
12780,"Bartlesville, OK",51886,Micropolitan Statistical Area,Native American,13,11,2,No meaningful results,,,,246,11,257
12780,"Bartlesville, OK",51886,Micropolitan Statistical Area,AAPI,13,13,0,No meaningful results,,,,246,11,257
17220,"Clarksburg, WV",93332,Micropolitan Statistical Area,Black,2,2,0,No meaningful results,,,,315,31,346
17220,"Clarksburg, WV",93332,Micropolitan Statistical Area,Latino,4,4,0,No meaningful results,,,,315,31,346
17220,"Clarksburg, WV",93332,Micropolitan Statistical Area,Native American,0,0,0,No meaningful results,,,,315,31,346
17220,"Clarksburg, WV",93332,Micropolitan Statistical Area,AAPI,4,4,0,No meaningful results,,,,315,31,346
10780,"Alexandria, LA",153310,Metropolitan Statistical Area,Black,31,27,4,Regression equation needs to be tweaked,7.521178432,7.5,75,368,12,380
10780,"Alexandria, LA",153310,Metropolitan Statistical Area,Latino,8,7,1,Regression equation needs to be tweaked,0.560714656,0.6,6,368,12,380
10780,"Alexandria, LA",153310,Metropolitan Statistical Area,Native American,4,2,2,Regression equation needs to be tweaked,18327903.82,18327903.8,183279038,368,12,380
10780,"Alexandria, LA",153310,Metropolitan Statistical Area,AAPI,13,13,0,Regression equation needs to be tweaked,1.16E-09,0,0,368,12,380
12620,"Bangor, ME",151774,Metropolitan Statistical Area,Black,6,6,0,No meaningful results,,,,722,48,770
12620,"Bangor, ME",151774,Metropolitan Statistical Area,Latino,10,10,0,No meaningful results,,,,722,48,770
12620,"Bangor, ME",151774,Metropolitan Statistical Area,Native American,5,5,0,No meaningful results,,,,722,48,770
12620,"Bangor, ME",151774,Metropolitan Statistical Area,AAPI,15,15,0,No meaningful results,,,,722,48,770
48980,"Wilson, NC",81435,Micropolitan Statistical Area,Black,66,53,13,No meaningful results,,,,268,15,283
48980,"Wilson, NC",81435,Micropolitan Statistical Area,Latino,23,20,3,No meaningful results,,,,268,15,283
48980,"Wilson, NC",81435,Micropolitan Statistical Area,Native American,2,2,0,No meaningful results,,,,268,15,283
48980,"Wilson, NC",81435,Micropolitan Statistical Area,AAPI,19,15,4,No meaningful results,,,,268,15,283
47080,"Vidalia, GA",36030,Micropolitan Statistical Area,Black,4,3,1,No meaningful results,,,,51,4,55
47080,"Vidalia, GA",36030,Micropolitan Statistical Area,Latino,1,1,0,No meaningful results,,,,51,4,55
47080,"Vidalia, GA",36030,Micropolitan Statistical Area,Native American,0,0,0,No meaningful results,,,,51,4,55
47080,"Vidalia, GA",36030,Micropolitan Statistical Area,AAPI,0,0,0,No meaningful results,,,,51,4,55
22900,"Fort Smith, AR-OK",249777,Metropolitan Statistical Area,Black,19,16,3,No meaningful results,,,,829,65,894
22900,"Fort Smith, AR-OK",249777,Metropolitan Statistical Area,Latino,98,87,11,No meaningful results,,,,829,65,894
22900,"Fort Smith, AR-OK",249777,Metropolitan Statistical Area,Native American,26,23,3,No meaningful results,,,,829,65,894
22900,"Fort Smith, AR-OK",249777,Metropolitan Statistical Area,AAPI,33,30,3,No meaningful results,,,,829,65,894
15020,"Brookhaven, MS",34320,Micropolitan Statistical Area,Black,4,3,1,No meaningful results,,,,53,5,58
15020,"Brookhaven, MS",34320,Micropolitan Statistical Area,Latino,0,0,0,No meaningful results,,,,53,5,58
15020,"Brookhaven, MS",34320,Micropolitan Statistical Area,Native American,0,0,0,No meaningful results,,,,53,5,58
15020,"Brookhaven, MS",34320,Micropolitan Statistical Area,AAPI,0,0,0,No meaningful results,,,,53,5,58
27660,"Jennings, LA",31441,Micropolitan Statistical Area,Black,5,5,0,No meaningful results,,,,81,5,86
27660,"Jennings, LA",31441,Micropolitan Statistical Area,Latino,1,1,0,No meaningful results,,,,81,5,86
27660,"Jennings, LA",31441,Micropolitan Statistical Area,Native American,0,0,0,No meaningful results,,,,81,5,86
27660,"Jennings, LA",31441,Micropolitan Statistical Area,AAPI,0,0,0,No meaningful results,,,,81,5,86
29380,"Lake City, FL",69968,Micropolitan Statistical Area,Black,7,7,0,No meaningful results,,,,169,15,184
29380,"Lake City, FL",69968,Micropolitan Statistical Area,Latino,18,17,1,No meaningful results,,,,169,15,184
29380,"Lake City, FL",69968,Micropolitan Statistical Area,Native American,1,1,0,No meaningful results,,,,169,15,184
29380,"Lake City, FL",69968,Micropolitan Statistical Area,AAPI,6,6,0,No meaningful results,,,,169,15,184
37120,"Ozark, AL",49277,Micropolitan Statistical Area,Black,4,4,0,No meaningful results,,,,75,4,79
37120,"Ozark, AL",49277,Micropolitan Statistical Area,Latino,2,2,0,No meaningful results,,,,75,4,79
37120,"Ozark, AL",49277,Micropolitan Statistical Area,Native American,1,1,0,No meaningful results,,,,75,4,79
37120,"Ozark, AL",49277,Micropolitan Statistical Area,AAPI,2,2,0,No meaningful results,,,,75,4,79
40460,"Rockingham, NC",44997,Micropolitan Statistical Area,Black,14,11,3,No meaningful results,,,,97,9,106
40460,"Rockingham, NC",44997,Micropolitan Statistical Area,Latino,9,8,1,No meaningful results,,,,97,9,106
40460,"Rockingham, NC",44997,Micropolitan Statistical Area,Native American,3,3,0,No meaningful results,,,,97,9,106
40460,"Rockingham, NC",44997,Micropolitan Statistical Area,AAPI,2,1,1,No meaningful results,,,,97,9,106
38820,"Port Angeles, WA",75392,Micropolitan Statistical Area,Black,3,3,0,No meaningful results,,,,360,17,377
38820,"Port Angeles, WA",75392,Micropolitan Statistical Area,Latino,17,17,0,No meaningful results,,,,360,17,377
38820,"Port Angeles, WA",75392,Micropolitan Statistical Area,Native American,6,6,0,No meaningful results,,,,360,17,377
38820,"Port Angeles, WA",75392,Micropolitan Statistical Area,AAPI,15,12,3,No meaningful results,,,,360,17,377
37660,"Parsons, KS",20119,Micropolitan Statistical Area,Black,2,1,1,No meaningful results,,,,22,7,29
37660,"Parsons, KS",20119,Micropolitan Statistical Area,Latino,1,1,0,No meaningful results,,,,22,7,29
37660,"Parsons, KS",20119,Micropolitan Statistical Area,Native American,0,0,0,No meaningful results,,,,22,7,29
37660,"Parsons, KS",20119,Micropolitan Statistical Area,AAPI,0,0,0,No meaningful results,,,,22,7,29
15580,"Butte-Silver Bow, MT",34770,Micropolitan Statistical Area,Black,0,0,0,No meaningful results,,,,200,16,216
15580,"Butte-Silver Bow, MT",34770,Micropolitan Statistical Area,Latino,2,2,0,No meaningful results,,,,200,16,216
15580,"Butte-Silver Bow, MT",34770,Micropolitan Statistical Area,Native American,0,0,0,No meaningful results,,,,200,16,216
15580,"Butte-Silver Bow, MT",34770,Micropolitan Statistical Area,AAPI,0,0,0,No meaningful results,,,,200,16,216
36580,"Oneonta, NY",59972,Micropolitan Statistical Area,Black,2,2,0,No meaningful results,,,,164,16,180
36580,"Oneonta, NY",59972,Micropolitan Statistical Area,Latino,5,5,0,No meaningful results,,,,164,16,180
36580,"Oneonta, NY",59972,Micropolitan Statistical Area,Native American,1,1,0,No meaningful results,,,,164,16,180
36580,"Oneonta, NY",59972,Micropolitan Statistical Area,AAPI,4,4,0,No meaningful results,,,,164,16,180
11220,"Amsterdam, NY",49302,Micropolitan Statistical Area,Black,0,0,0,No meaningful results,,,,113,12,125
11220,"Amsterdam, NY",49302,Micropolitan Statistical Area,Latino,8,6,2,No meaningful results,,,,113,12,125
11220,"Amsterdam, NY",49302,Micropolitan Statistical Area,Native American,1,0,1,No meaningful results,,,,113,12,125
11220,"Amsterdam, NY",49302,Micropolitan Statistical Area,AAPI,1,1,0,No meaningful results,,,,113,12,125
13780,"Binghamton, NY",241874,Metropolitan Statistical Area,Black,19,15,4,Regression equation needs to be tweaked,6.725917409,6.7,67,844,59,903
13780,"Binghamton, NY",241874,Metropolitan Statistical Area,Latino,23,23,0,Regression equation needs to be tweaked,3.03E-09,0,0,844,59,903
13780,"Binghamton, NY",241874,Metropolitan Statistical Area,Native American,2,2,0,Regression equation needs to be tweaked,1.16E-08,0,0,844,59,903
13780,"Binghamton, NY",241874,Metropolitan Statistical Area,AAPI,34,28,6,Regression equation needs to be tweaked,8.468896483,8.5,85,844,59,903
18660,"Cortland, NY",47865,Micropolitan Statistical Area,Black,0,0,0,No meaningful results,,,,142,12,154
18660,"Cortland, NY",47865,Micropolitan Statistical Area,Latino,3,3,0,No meaningful results,,,,142,12,154
18660,"Cortland, NY",47865,Micropolitan Statistical Area,Native American,2,2,0,No meaningful results,,,,142,12,154
18660,"Cortland, NY",47865,Micropolitan Statistical Area,AAPI,4,4,0,No meaningful results,,,,142,12,154
33180,"Middlesborough, KY",26791,Micropolitan Statistical Area,Black,0,0,0,No meaningful results,,,,23,3,26
33180,"Middlesborough, KY",26791,Micropolitan Statistical Area,Latino,0,0,0,No meaningful results,,,,23,3,26
33180,"Middlesborough, KY",26791,Micropolitan Statistical Area,Native American,0,0,0,No meaningful results,,,,23,3,26
33180,"Middlesborough, KY",26791,Micropolitan Statistical Area,AAPI,1,1,0,No meaningful results,,,,23,3,26
16380,"Celina, OH",40884,Micropolitan Statistical Area,Black,2,2,0,No meaningful results,,,,114,9,123
16380,"Celina, OH",40884,Micropolitan Statistical Area,Latino,0,0,0,No meaningful results,,,,114,9,123
16380,"Celina, OH",40884,Micropolitan Statistical Area,Native American,0,0,0,No meaningful results,,,,114,9,123
16380,"Celina, OH",40884,Micropolitan Statistical Area,AAPI,0,0,0,No meaningful results,,,,114,9,123
30900,"Logansport, IN",37880,Micropolitan Statistical Area,Black,0,0,0,No meaningful results,,,,116,5,121
30900,"Logansport, IN",37880,Micropolitan Statistical Area,Latino,21,17,4,No meaningful results,,,,116,5,121
30900,"Logansport, IN",37880,Micropolitan Statistical Area,Native American,1,1,0,No meaningful results,,,,116,5,121
30900,"Logansport, IN",37880,Micropolitan Statistical Area,AAPI,5,5,0,No meaningful results,,,,116,5,121
41400,"Salem, OH",103190,Micropolitan Statistical Area,Black,2,2,0,No meaningful results,,,,434,35,469
41400,"Salem, OH",103190,Micropolitan Statistical Area,Latino,3,2,1,No meaningful results,,,,434,35,469
41400,"Salem, OH",103190,Micropolitan Statistical Area,Native American,0,0,0,No meaningful results,,,,434,35,469
41400,"Salem, OH",103190,Micropolitan Statistical Area,AAPI,2,2,0,No meaningful results,,,,434,35,469
24220,"Grand Forks, ND-MN",101745,Metropolitan Statistical Area,Black,4,4,0,No meaningful results,,,,592,19,611
24220,"Grand Forks, ND-MN",101745,Metropolitan Statistical Area,Latino,10,9,1,No meaningful results,,,,592,19,611
24220,"Grand Forks, ND-MN",101745,Metropolitan Statistical Area,Native American,7,6,1,No meaningful results,,,,592,19,611
24220,"Grand Forks, ND-MN",101745,Metropolitan Statistical Area,AAPI,11,10,1,No meaningful results,,,,592,19,611
47540,"Wapakoneta, OH",45729,Micropolitan Statistical Area,Black,0,0,0,No meaningful results,,,,234,29,263
47540,"Wapakoneta, OH",45729,Micropolitan Statistical Area,Latino,2,2,0,No meaningful results,,,,234,29,263
47540,"Wapakoneta, OH",45729,Micropolitan Statistical Area,Native American,3,2,1,No meaningful results,,,,234,29,263
47540,"Wapakoneta, OH",45729,Micropolitan Statistical Area,AAPI,4,2,2,No meaningful results,,,,234,29,263
36980,"Owensboro, KY",118477,Metropolitan Statistical Area,Black,10,9,1,No meaningful results,,,,760,32,792
36980,"Owensboro, KY",118477,Metropolitan Statistical Area,Latino,10,8,2,No meaningful results,,,,760,32,792
36980,"Owensboro, KY",118477,Metropolitan Statistical Area,Native American,0,0,0,No meaningful results,,,,760,32,792
36980,"Owensboro, KY",118477,Metropolitan Statistical Area,AAPI,32,29,3,No meaningful results,,,,760,32,792
31580,"Madisonville, KY",45331,Micropolitan Statistical Area,Black,1,1,0,No meaningful results,,,,110,7,117
31580,"Madisonville, KY",45331,Micropolitan Statistical Area,Latino,2,2,0,No meaningful results,,,,110,7,117
31580,"Madisonville, KY",45331,Micropolitan Statistical Area,Native American,0,0,0,No meaningful results,,,,110,7,117
31580,"Madisonville, KY",45331,Micropolitan Statistical Area,AAPI,0,0,0,No meaningful results,,,,110,7,117
12860,"Batavia, NY",57808,Micropolitan Statistical Area,Black,1,1,0,No meaningful results,,,,203,8,211
12860,"Batavia, NY",57808,Micropolitan Statistical Area,Latino,2,2,0,No meaningful results,,,,203,8,211
12860,"Batavia, NY",57808,Micropolitan Statistical Area,Native American,1,1,0,No meaningful results,,,,203,8,211
12860,"Batavia, NY",57808,Micropolitan Statistical Area,AAPI,1,1,0,No meaningful results,,,,203,8,211
46540,"Utica-Rome, NY",292016,Metropolitan Statistical Area,Black,16,11,5,No meaningful results,,,,1030,102,1132
46540,"Utica-Rome, NY",292016,Metropolitan Statistical Area,Latino,21,20,1,No meaningful results,,,,1030,102,1132
46540,"Utica-Rome, NY",292016,Metropolitan Statistical Area,Native American,2,2,0,No meaningful results,,,,1030,102,1132
46540,"Utica-Rome, NY",292016,Metropolitan Statistical Area,AAPI,36,31,5,No meaningful results,,,,1030,102,1132
27460,"Jamestown-Dunkirk-Fredonia, NY",128496,Micropolitan Statistical Area,Black,5,5,0,No meaningful results,,,,404,40,444
27460,"Jamestown-Dunkirk-Fredonia, NY",128496,Micropolitan Statistical Area,Latino,25,23,2,No meaningful results,,,,404,40,444
27460,"Jamestown-Dunkirk-Fredonia, NY",128496,Micropolitan Statistical Area,Native American,2,2,0,No meaningful results,,,,404,40,444
27460,"Jamestown-Dunkirk-Fredonia, NY",128496,Micropolitan Statistical Area,AAPI,6,6,0,No meaningful results,,,,404,40,444
38460,"Plattsburgh, NY",80583,Micropolitan Statistical Area,Black,1,1,0,No meaningful results,,,,200,14,214
38460,"Plattsburgh, NY",80583,Micropolitan Statistical Area,Latino,4,4,0,No meaningful results,,,,200,14,214
38460,"Plattsburgh, NY",80583,Micropolitan Statistical Area,Native American,1,1,0,No meaningful results,,,,200,14,214
38460,"Plattsburgh, NY",80583,Micropolitan Statistical Area,AAPI,6,6,0,No meaningful results,,,,200,14,214
23380,"Fremont, OH",59029,Micropolitan Statistical Area,Black,1,1,0,No meaningful results,,,,191,13,204
23380,"Fremont, OH",59029,Micropolitan Statistical Area,Latino,10,10,0,No meaningful results,,,,191,13,204
23380,"Fremont, OH",59029,Micropolitan Statistical Area,Native American,0,0,0,No meaningful results,,,,191,13,204
23380,"Fremont, OH",59029,Micropolitan Statistical Area,AAPI,1,1,0,No meaningful results,,,,191,13,204
47620,"Warren, PA",39756,Micropolitan Statistical Area,Black,0,0,0,No meaningful results,,,,155,22,177
47620,"Warren, PA",39756,Micropolitan Statistical Area,Latino,0,0,0,No meaningful results,,,,155,22,177
47620,"Warren, PA",39756,Micropolitan Statistical Area,Native American,0,0,0,No meaningful results,,,,155,22,177
47620,"Warren, PA",39756,Micropolitan Statistical Area,AAPI,3,2,1,No meaningful results,,,,155,22,177
24100,"Gloversville, NY",53646,Micropolitan Statistical Area,Black,0,0,0,No meaningful results,,,,144,23,167
24100,"Gloversville, NY",53646,Micropolitan Statistical Area,Latino,5,4,1,No meaningful results,,,,144,23,167
24100,"Gloversville, NY",53646,Micropolitan Statistical Area,Native American,1,1,0,No meaningful results,,,,144,23,167
24100,"Gloversville, NY",53646,Micropolitan Statistical Area,AAPI,4,4,0,No meaningful results,,,,144,23,167
26460,"Hudson, NY",60371,Micropolitan Statistical Area,Black,6,6,0,No meaningful results,,,,240,16,256
26460,"Hudson, NY",60371,Micropolitan Statistical Area,Latino,8,6,2,No meaningful results,,,,240,16,256
26460,"Hudson, NY",60371,Micropolitan Statistical Area,Native American,1,1,0,No meaningful results,,,,240,16,256
26460,"Hudson, NY",60371,Micropolitan Statistical Area,AAPI,12,12,0,No meaningful results,,,,240,16,256
41780,"Sandusky, OH",74780,Micropolitan Statistical Area,Black,10,9,1,No meaningful results,,,,394,20,414
41780,"Sandusky, OH",74780,Micropolitan Statistical Area,Latino,5,5,0,No meaningful results,,,,394,20,414
41780,"Sandusky, OH",74780,Micropolitan Statistical Area,Native American,1,1,0,No meaningful results,,,,394,20,414
41780,"Sandusky, OH",74780,Micropolitan Statistical Area,AAPI,1,1,0,No meaningful results,,,,394,20,414
35940,"Norwalk, OH",58339,Micropolitan Statistical Area,Black,0,0,0,No meaningful results,,,,239,14,253
35940,"Norwalk, OH",58339,Micropolitan Statistical Area,Latino,8,7,1,No meaningful results,,,,239,14,253
35940,"Norwalk, OH",58339,Micropolitan Statistical Area,Native American,0,0,0,No meaningful results,,,,239,14,253
35940,"Norwalk, OH",58339,Micropolitan Statistical Area,AAPI,0,0,0,No meaningful results,,,,239,14,253
21300,"Elmira, NY",84895,Metropolitan Statistical Area,Black,7,5,2,No meaningful results,,,,390,38,428
21300,"Elmira, NY",84895,Metropolitan Statistical Area,Latino,12,10,2,No meaningful results,,,,390,38,428
21300,"Elmira, NY",84895,Metropolitan Statistical Area,Native American,0,0,0,No meaningful results,,,,390,38,428
21300,"Elmira, NY",84895,Metropolitan Statistical Area,AAPI,12,12,0,No meaningful results,,,,390,38,428
12180,"Auburn, NY",77425,Micropolitan Statistical Area,Black,0,0,0,No meaningful results,,,,235,15,250
12180,"Auburn, NY",77425,Micropolitan Statistical Area,Latino,0,0,0,No meaningful results,,,,235,15,250
12180,"Auburn, NY",77425,Micropolitan Statistical Area,Native American,0,0,0,No meaningful results,,,,235,15,250
12180,"Auburn, NY",77425,Micropolitan Statistical Area,AAPI,1,1,0,No meaningful results,,,,235,15,250
24020,"Glens Falls, NY",125892,Metropolitan Statistical Area,Black,0,0,0,No meaningful results,,,,584,33,617
24020,"Glens Falls, NY",125892,Metropolitan Statistical Area,Latino,10,9,1,No meaningful results,,,,584,33,617
24020,"Glens Falls, NY",125892,Metropolitan Statistical Area,Native American,2,2,0,No meaningful results,,,,584,33,617
24020,"Glens Falls, NY",125892,Metropolitan Statistical Area,AAPI,9,9,0,No meaningful results,,,,584,33,617
28580,"Key West, FL",75798,Micropolitan Statistical Area,Black,5,3,2,Regression equation needs to be tweaked,7.803833461,7.8,78,343,54,397
28580,"Key West, FL",75798,Micropolitan Statistical Area,Latino,92,76,16,Regression equation needs to be tweaked,0.971967916,1,10,343,54,397
28580,"Key West, FL",75798,Micropolitan Statistical Area,Native American,1,1,0,Regression equation needs to be tweaked,9.13E-11,0,0,343,54,397
28580,"Key West, FL",75798,Micropolitan Statistical Area,AAPI,4,4,0,Regression equation needs to be tweaked,3.98E-11,0,0,343,54,397
30140,"Lebanon, PA",139729,Metropolitan Statistical Area,Black,7,7,0,Regression equation needs to be tweaked,0.000935322,0,0,720,41,761
30140,"Lebanon, PA",139729,Metropolitan Statistical Area,Latino,66,57,9,Regression equation needs to be tweaked,3.535321794,3.5,35,720,41,761
30140,"Lebanon, PA",139729,Metropolitan Statistical Area,Native American,2,1,1,Regression equation needs to be tweaked,40.76338379,40.8,408,720,41,761
30140,"Lebanon, PA",139729,Metropolitan Statistical Area,AAPI,47,44,3,Regression equation needs to be tweaked,1.146914849,1.1,11,720,41,761
22300,"Findlay, OH",75837,Micropolitan Statistical Area,Black,15,15,0,No meaningful results,,,,639,15,654
22300,"Findlay, OH",75837,Micropolitan Statistical Area,Latino,29,28,1,No meaningful results,,,,639,15,654
22300,"Findlay, OH",75837,Micropolitan Statistical Area,Native American,2,1,1,No meaningful results,,,,639,15,654
22300,"Findlay, OH",75837,Micropolitan Statistical Area,AAPI,15,14,1,No meaningful results,,,,639,15,654
27060,"Ithaca, NY",102642,Metropolitan Statistical Area,Black,4,4,0,No meaningful results,,,,276,11,287
27060,"Ithaca, NY",102642,Metropolitan Statistical Area,Latino,10,9,1,No meaningful results,,,,276,11,287
27060,"Ithaca, NY",102642,Metropolitan Statistical Area,Native American,2,1,1,No meaningful results,,,,276,11,287
27060,"Ithaca, NY",102642,Metropolitan Statistical Area,AAPI,29,28,1,No meaningful results,,,,276,11,287
34620,"Muncie, IN",115020,Metropolitan Statistical Area,Black,14,11,3,Regression equation needs to be tweaked,3.880371332,3.9,39,544,42,586
34620,"Muncie, IN",115020,Metropolitan Statistical Area,Latino,7,6,1,Regression equation needs to be tweaked,0.627780436,0.6,6,544,42,586
34620,"Muncie, IN",115020,Metropolitan Statistical Area,Native American,0,0,0,Regression equation needs to be tweaked,12782299.31,12782299.3,127822993,544,42,586
34620,"Muncie, IN",115020,Metropolitan Statistical Area,AAPI,19,16,3,Regression equation needs to be tweaked,1.08349327,1.1,11,544,42,586
36460,"Olean, NY",77121,Micropolitan Statistical Area,Black,4,4,0,No meaningful results,,,,182,23,205
36460,"Olean, NY",77121,Micropolitan Statistical Area,Latino,3,1,2,No meaningful results,,,,182,23,205
36460,"Olean, NY",77121,Micropolitan Statistical Area,Native American,2,2,0,No meaningful results,,,,182,23,205
36460,"Olean, NY",77121,Micropolitan Statistical Area,AAPI,2,2,0,No meaningful results,,,,182,23,205
31660,"Malone, NY",50477,Micropolitan Statistical Area,Black,0,0,0,No meaningful results,,,,93,9,102
31660,"Malone, NY",50477,Micropolitan Statistical Area,Latino,1,1,0,No meaningful results,,,,93,9,102
31660,"Malone, NY",50477,Micropolitan Statistical Area,Native American,1,0,1,No meaningful results,,,,93,9,102
31660,"Malone, NY",50477,Micropolitan Statistical Area,AAPI,0,0,0,No meaningful results,,,,93,9,102
42380,"Sayre, PA",60963,Micropolitan Statistical Area,Black,2,0,2,No meaningful results,,,,249,24,273
42380,"Sayre, PA",60963,Micropolitan Statistical Area,Latino,4,4,0,No meaningful results,,,,249,24,273
42380,"Sayre, PA",60963,Micropolitan Statistical Area,Native American,0,0,0,No meaningful results,,,,249,24,273
42380,"Sayre, PA",60963,Micropolitan Statistical Area,AAPI,3,3,0,No meaningful results,,,,249,24,273
39020,"Portsmouth, OH",76040,Micropolitan Statistical Area,Black,3,3,0,No meaningful results,,,,247,15,262
39020,"Portsmouth, OH",76040,Micropolitan Statistical Area,Latino,3,3,0,No meaningful results,,,,247,15,262
39020,"Portsmouth, OH",76040,Micropolitan Statistical Area,Native American,0,0,0,No meaningful results,,,,247,15,262
39020,"Portsmouth, OH",76040,Micropolitan Statistical Area,AAPI,4,4,0,No meaningful results,,,,247,15,262
25880,"Hillsdale, MI",45757,Micropolitan Statistical Area,Black,1,1,0,No meaningful results,,,,203,9,212
25880,"Hillsdale, MI",45757,Micropolitan Statistical Area,Latino,3,3,0,No meaningful results,,,,203,9,212
25880,"Hillsdale, MI",45757,Micropolitan Statistical Area,Native American,0,0,0,No meaningful results,,,,203,9,212
25880,"Hillsdale, MI",45757,Micropolitan Statistical Area,AAPI,3,2,1,No meaningful results,,,,203,9,212
35860,"North Vernon, IN",27710,Micropolitan Statistical Area,Black,2,2,0,No meaningful results,,,,83,14,97
35860,"North Vernon, IN",27710,Micropolitan Statistical Area,Latino,2,2,0,No meaningful results,,,,83,14,97
35860,"North Vernon, IN",27710,Micropolitan Statistical Area,Native American,0,0,0,No meaningful results,,,,83,14,97
35860,"North Vernon, IN",27710,Micropolitan Statistical Area,AAPI,0,0,0,No meaningful results,,,,83,14,97
35660,"Niles, MI",154133,Metropolitan Statistical Area,Black,36,30,6,Regression equation needs to be tweaked,3.689161165,3.7,37,986,51,1037
35660,"Niles, MI",154133,Metropolitan Statistical Area,Latino,42,40,2,Regression equation needs to be tweaked,1.016737544,1,10,986,51,1037
35660,"Niles, MI",154133,Metropolitan Statistical Area,Native American,11,11,0,Regression equation needs to be tweaked,1.74E-12,0,0,986,51,1037
35660,"Niles, MI",154133,Metropolitan Statistical Area,AAPI,36,36,0,Regression equation needs to be tweaked,6.12E-10,0,0,986,51,1037
39980,"Richmond, IN",66342,Micropolitan Statistical Area,Black,5,4,1,No meaningful results,,,,189,10,199
39980,"Richmond, IN",66342,Micropolitan Statistical Area,Latino,6,4,2,No meaningful results,,,,189,10,199
39980,"Richmond, IN",66342,Micropolitan Statistical Area,Native American,0,0,0,No meaningful results,,,,189,10,199
39980,"Richmond, IN",66342,Micropolitan Statistical Area,AAPI,3,3,0,No meaningful results,,,,189,10,199
32940,"Meridian, MS",101992,Micropolitan Statistical Area,Black,21,16,5,No meaningful results,,,,103,6,109
32940,"Meridian, MS",101992,Micropolitan Statistical Area,Latino,0,0,0,No meaningful results,,,,103,6,109
32940,"Meridian, MS",101992,Micropolitan Statistical Area,Native American,0,0,0,No meaningful results,,,,103,6,109
32940,"Meridian, MS",101992,Micropolitan Statistical Area,AAPI,4,3,1,No meaningful results,,,,103,6,109
30220,"Levelland, TX",23064,Micropolitan Statistical Area,Black,2,2,0,No meaningful results,,,,43,5,48
30220,"Levelland, TX",23064,Micropolitan Statistical Area,Latino,34,30,4,No meaningful results,,,,43,5,48
30220,"Levelland, TX",23064,Micropolitan Statistical Area,Native American,1,1,0,No meaningful results,,,,43,5,48
30220,"Levelland, TX",23064,Micropolitan Statistical Area,AAPI,0,0,0,No meaningful results,,,,43,5,48
26380,"Houma-Thibodaux, LA",210162,Metropolitan Statistical Area,Black,31,26,5,Regression equation needs to be tweaked,2.602881872,2.6,26,570,35,605
26380,"Houma-Thibodaux, LA",210162,Metropolitan Statistical Area,Latino,16,16,0,Regression equation needs to be tweaked,5.35E-08,0,0,570,35,605
26380,"Houma-Thibodaux, LA",210162,Metropolitan Statistical Area,Native American,9,8,1,Regression equation needs to be tweaked,1.118716597,1.1,11,570,35,605
26380,"Houma-Thibodaux, LA",210162,Metropolitan Statistical Area,AAPI,7,6,1,Regression equation needs to be tweaked,1.665608991,1.7,17,570,35,605
14020,"Bloomington, IN",167296,Metropolitan Statistical Area,Black,11,10,1,No meaningful results,,,,1018,50,1068
14020,"Bloomington, IN",167296,Metropolitan Statistical Area,Latino,38,33,5,No meaningful results,,,,1018,50,1068
14020,"Bloomington, IN",167296,Metropolitan Statistical Area,Native American,2,2,0,No meaningful results,,,,1018,50,1068
14020,"Bloomington, IN",167296,Metropolitan Statistical Area,AAPI,55,53,2,No meaningful results,,,,1018,50,1068
15060,"Brookings, OR",22650,Micropolitan Statistical Area,Black,4,2,2,No meaningful results,,,,106,8,114
15060,"Brookings, OR",22650,Micropolitan Statistical Area,Latino,4,4,0,No meaningful results,,,,106,8,114
15060,"Brookings, OR",22650,Micropolitan Statistical Area,Native American,0,0,0,No meaningful results,,,,106,8,114
15060,"Brookings, OR",22650,Micropolitan Statistical Area,AAPI,3,3,0,No meaningful results,,,,106,8,114
43460,"Sikeston, MO",38633,Micropolitan Statistical Area,Black,2,1,1,No meaningful results,,,,96,7,103
43460,"Sikeston, MO",38633,Micropolitan Statistical Area,Latino,1,0,1,No meaningful results,,,,96,7,103
43460,"Sikeston, MO",38633,Micropolitan Statistical Area,Native American,1,0,1,No meaningful results,,,,96,7,103
43460,"Sikeston, MO",38633,Micropolitan Statistical Area,AAPI,1,1,0,No meaningful results,,,,96,7,103
38100,"Picayune, MS",55219,Micropolitan Statistical Area,Black,3,3,0,No meaningful results,,,,129,17,146
38100,"Picayune, MS",55219,Micropolitan Statistical Area,Latino,5,4,1,No meaningful results,,,,129,17,146
38100,"Picayune, MS",55219,Micropolitan Statistical Area,Native American,0,0,0,No meaningful results,,,,129,17,146
38100,"Picayune, MS",55219,Micropolitan Statistical Area,AAPI,3,2,1,No meaningful results,,,,129,17,146
44860,"Sulphur Springs, TX",36486,Micropolitan Statistical Area,Black,4,3,1,No meaningful results,,,,109,3,112
44860,"Sulphur Springs, TX",36486,Micropolitan Statistical Area,Latino,17,13,4,No meaningful results,,,,109,3,112
44860,"Sulphur Springs, TX",36486,Micropolitan Statistical Area,Native American,1,1,0,No meaningful results,,,,109,3,112
44860,"Sulphur Springs, TX",36486,Micropolitan Statistical Area,AAPI,5,4,1,No meaningful results,,,,109,3,112
28860,"Kirksville, MO",29924,Micropolitan Statistical Area,Black,3,3,0,No meaningful results,,,,65,4,69
28860,"Kirksville, MO",29924,Micropolitan Statistical Area,Latino,2,1,1,No meaningful results,,,,65,4,69
28860,"Kirksville, MO",29924,Micropolitan Statistical Area,Native American,0,0,0,No meaningful results,,,,65,4,69
28860,"Kirksville, MO",29924,Micropolitan Statistical Area,AAPI,5,5,0,No meaningful results,,,,65,4,69
30060,"Lebanon, MO",35531,Micropolitan Statistical Area,Black,0,0,0,No meaningful results,,,,126,13,139
30060,"Lebanon, MO",35531,Micropolitan Statistical Area,Latino,3,3,0,No meaningful results,,,,126,13,139
30060,"Lebanon, MO",35531,Micropolitan Statistical Area,Native American,0,0,0,No meaningful results,,,,126,13,139
30060,"Lebanon, MO",35531,Micropolitan Statistical Area,AAPI,0,0,0,No meaningful results,,,,126,13,139
21840,"Fairfield, IA",18148,Micropolitan Statistical Area,Black,0,0,0,No meaningful results,,,,45,12,57
21840,"Fairfield, IA",18148,Micropolitan Statistical Area,Latino,3,2,1,No meaningful results,,,,45,12,57
21840,"Fairfield, IA",18148,Micropolitan Statistical Area,Native American,1,0,1,No meaningful results,,,,45,12,57
21840,"Fairfield, IA",18148,Micropolitan Statistical Area,AAPI,4,3,1,No meaningful results,,,,45,12,57
33380,"Minden, LA",39242,Micropolitan Statistical Area,Black,8,5,3,No meaningful results,,,,47,7,54
33380,"Minden, LA",39242,Micropolitan Statistical Area,Latino,1,1,0,No meaningful results,,,,47,7,54
33380,"Minden, LA",39242,Micropolitan Statistical Area,Native American,0,0,0,No meaningful results,,,,47,7,54
33380,"Minden, LA",39242,Micropolitan Statistical Area,AAPI,0,0,0,No meaningful results,,,,47,7,54
22800,"Fort Madison-Keokuk, IA-IL-MO",58989,Micropolitan Statistical Area,Black,1,1,0,No meaningful results,,,,120,20,140
22800,"Fort Madison-Keokuk, IA-IL-MO",58989,Micropolitan Statistical Area,Latino,0,0,0,No meaningful results,,,,120,20,140
22800,"Fort Madison-Keokuk, IA-IL-MO",58989,Micropolitan Statistical Area,Native American,0,0,0,No meaningful results,,,,120,20,140
22800,"Fort Madison-Keokuk, IA-IL-MO",58989,Micropolitan Statistical Area,AAPI,0,0,0,No meaningful results,,,,120,20,140
29860,"Laurel, MS",84857,Micropolitan Statistical Area,Black,14,10,4,No meaningful results,,,,144,5,149
29860,"Laurel, MS",84857,Micropolitan Statistical Area,Latino,6,5,1,No meaningful results,,,,144,5,149
29860,"Laurel, MS",84857,Micropolitan Statistical Area,Native American,0,0,0,No meaningful results,,,,144,5,149
29860,"Laurel, MS",84857,Micropolitan Statistical Area,AAPI,5,4,1,No meaningful results,,,,144,5,149
16020,"Cape Girardeau, MO-IL",96976,Metropolitan Statistical Area,Black,2,2,0,Regression equation needs to be tweaked,8.65E-09,0,0,419,31,450
16020,"Cape Girardeau, MO-IL",96976,Metropolitan Statistical Area,Latino,8,6,2,Regression equation needs to be tweaked,17.84383771,17.8,178,419,31,450
16020,"Cape Girardeau, MO-IL",96976,Metropolitan Statistical Area,Native American,0,0,0,Regression equation needs to be tweaked,9.22E+19,9.22E+19,9.22E+20,419,31,450
16020,"Cape Girardeau, MO-IL",96976,Metropolitan Statistical Area,AAPI,6,5,1,Regression equation needs to be tweaked,1.811299437,1.8,18,419,31,450
21980,"Fallon, NV",24259,Micropolitan Statistical Area,Black,0,0,0,No meaningful results,,,,77,3,80
21980,"Fallon, NV",24259,Micropolitan Statistical Area,Latino,11,9,2,No meaningful results,,,,77,3,80
21980,"Fallon, NV",24259,Micropolitan Statistical Area,Native American,2,2,0,No meaningful results,,,,77,3,80
21980,"Fallon, NV",24259,Micropolitan Statistical Area,AAPI,4,4,0,No meaningful results,,,,77,3,80
36660,"Opelousas, LA",83172,Micropolitan Statistical Area,Black,37,29,8,Regression equation needs to be tweaked,53.29048168,53.3,533,109,11,120
36660,"Opelousas, LA",83172,Micropolitan Statistical Area,Latino,3,2,1,Regression equation needs to be tweaked,30.54492012,30.5,305,109,11,120
36660,"Opelousas, LA",83172,Micropolitan Statistical Area,Native American,0,0,0,Regression equation needs to be tweaked,420031.4915,420031.5,4200315,109,11,120
36660,"Opelousas, LA",83172,Micropolitan Statistical Area,AAPI,2,2,0,Regression equation needs to be tweaked,0.011327884,0,0,109,11,120
26940,"Indianola, MS",26168,Micropolitan Statistical Area,Black,33,26,7,No meaningful results,,,,23,4,27
26940,"Indianola, MS",26168,Micropolitan Statistical Area,Latino,0,0,0,No meaningful results,,,,23,4,27
26940,"Indianola, MS",26168,Micropolitan Statistical Area,Native American,0,0,0,No meaningful results,,,,23,4,27
26940,"Indianola, MS",26168,Micropolitan Statistical Area,AAPI,2,1,1,No meaningful results,,,,23,4,27
13620,"Berlin, NH",31741,Micropolitan Statistical Area,Black,0,0,0,No meaningful results,,,,102,10,112
13620,"Berlin, NH",31741,Micropolitan Statistical Area,Latino,5,3,2,No meaningful results,,,,102,10,112
13620,"Berlin, NH",31741,Micropolitan Statistical Area,Native American,0,0,0,No meaningful results,,,,102,10,112
13620,"Berlin, NH",31741,Micropolitan Statistical Area,AAPI,0,0,0,No meaningful results,,,,102,10,112
37420,"Pampa, TX",23215,Micropolitan Statistical Area,Black,0,0,0,No meaningful results,,,,54,6,60
37420,"Pampa, TX",23215,Micropolitan Statistical Area,Latino,9,5,4,No meaningful results,,,,54,6,60
37420,"Pampa, TX",23215,Micropolitan Statistical Area,Native American,0,0,0,No meaningful results,,,,54,6,60
37420,"Pampa, TX",23215,Micropolitan Statistical Area,AAPI,1,0,1,No meaningful results,,,,54,6,60
33020,"Mexico, MO",25644,Micropolitan Statistical Area,Black,0,0,0,No meaningful results,,,,61,7,68
33020,"Mexico, MO",25644,Micropolitan Statistical Area,Latino,2,1,1,No meaningful results,,,,61,7,68
33020,"Mexico, MO",25644,Micropolitan Statistical Area,Native American,1,1,0,No meaningful results,,,,61,7,68
33020,"Mexico, MO",25644,Micropolitan Statistical Area,AAPI,0,0,0,No meaningful results,,,,61,7,68
22780,"Fort Leonard Wood, MO",52425,Micropolitan Statistical Area,Black,0,0,0,No meaningful results,,,,63,3,66
22780,"Fort Leonard Wood, MO",52425,Micropolitan Statistical Area,Latino,2,2,0,No meaningful results,,,,63,3,66
22780,"Fort Leonard Wood, MO",52425,Micropolitan Statistical Area,Native American,1,1,0,No meaningful results,,,,63,3,66
22780,"Fort Leonard Wood, MO",52425,Micropolitan Statistical Area,AAPI,1,0,1,No meaningful results,,,,63,3,66
33620,"Moberly, MO",24878,Micropolitan Statistical Area,Black,0,0,0,No meaningful results,,,,51,10,61
33620,"Moberly, MO",24878,Micropolitan Statistical Area,Latino,0,0,0,No meaningful results,,,,51,10,61
33620,"Moberly, MO",24878,Micropolitan Statistical Area,Native American,0,0,0,No meaningful results,,,,51,10,61
33620,"Moberly, MO",24878,Micropolitan Statistical Area,AAPI,0,0,0,No meaningful results,,,,51,10,61
38740,"Poplar Bluff, MO",56223,Micropolitan Statistical Area,Black,2,2,0,No meaningful results,,,,94,5,99
38740,"Poplar Bluff, MO",56223,Micropolitan Statistical Area,Latino,0,0,0,No meaningful results,,,,94,5,99
38740,"Poplar Bluff, MO",56223,Micropolitan Statistical Area,Native American,0,0,0,No meaningful results,,,,94,5,99
38740,"Poplar Bluff, MO",56223,Micropolitan Statistical Area,AAPI,3,2,1,No meaningful results,,,,94,5,99
32300,"Martinsville, VA",64160,Micropolitan Statistical Area,Black,12,10,2,No meaningful results,,,,110,7,117
32300,"Martinsville, VA",64160,Micropolitan Statistical Area,Latino,5,4,1,No meaningful results,,,,110,7,117
32300,"Martinsville, VA",64160,Micropolitan Statistical Area,Native American,0,0,0,No meaningful results,,,,110,7,117
32300,"Martinsville, VA",64160,Micropolitan Statistical Area,AAPI,2,2,0,No meaningful results,,,,110,7,117
32740,"Meadville, PA",85665,Micropolitan Statistical Area,Black,1,1,0,No meaningful results,,,,299,28,327
32740,"Meadville, PA",85665,Micropolitan Statistical Area,Latino,1,1,0,No meaningful results,,,,299,28,327
32740,"Meadville, PA",85665,Micropolitan Statistical Area,Native American,0,0,0,No meaningful results,,,,299,28,327
32740,"Meadville, PA",85665,Micropolitan Statistical Area,AAPI,2,2,0,No meaningful results,,,,299,28,327
41260,"St. Marys, PA",30340,Micropolitan Statistical Area,Black,0,0,0,No meaningful results,,,,142,25,167
41260,"St. Marys, PA",30340,Micropolitan Statistical Area,Latino,3,3,0,No meaningful results,,,,142,25,167
41260,"St. Marys, PA",30340,Micropolitan Statistical Area,Native American,0,0,0,No meaningful results,,,,142,25,167
41260,"St. Marys, PA",30340,Micropolitan Statistical Area,AAPI,0,0,0,No meaningful results,,,,142,25,167
46420,"Union, SC",27490,Micropolitan Statistical Area,Black,7,2,5,No meaningful results,,,,34,8,42
46420,"Union, SC",27490,Micropolitan Statistical Area,Latino,0,0,0,No meaningful results,,,,34,8,42
46420,"Union, SC",27490,Micropolitan Statistical Area,Native American,1,1,0,No meaningful results,,,,34,8,42
46420,"Union, SC",27490,Micropolitan Statistical Area,AAPI,0,0,0,No meaningful results,,,,34,8,42
25500,"Harrisonburg, VA",133557,Metropolitan Statistical Area,Black,22,20,2,No meaningful results,,,,641,25,666
25500,"Harrisonburg, VA",133557,Metropolitan Statistical Area,Latino,65,59,6,No meaningful results,,,,641,25,666
25500,"Harrisonburg, VA",133557,Metropolitan Statistical Area,Native American,2,2,0,No meaningful results,,,,641,25,666
25500,"Harrisonburg, VA",133557,Metropolitan Statistical Area,AAPI,28,28,0,No meaningful results,,,,641,25,666
10460,"Alamogordo, NM",66137,Micropolitan Statistical Area,Black,0,0,0,No meaningful results,,,,89,8,97
10460,"Alamogordo, NM",66137,Micropolitan Statistical Area,Latino,22,18,4,No meaningful results,,,,89,8,97
10460,"Alamogordo, NM",66137,Micropolitan Statistical Area,Native American,0,0,0,No meaningful results,,,,89,8,97
10460,"Alamogordo, NM",66137,Micropolitan Statistical Area,AAPI,1,1,0,No meaningful results,,,,89,8,97
13700,"Big Spring, TX",36349,Micropolitan Statistical Area,Black,1,1,0,No meaningful results,,,,70,6,76
13700,"Big Spring, TX",36349,Micropolitan Statistical Area,Latino,22,20,2,No meaningful results,,,,70,6,76
13700,"Big Spring, TX",36349,Micropolitan Statistical Area,Native American,1,1,0,No meaningful results,,,,70,6,76
13700,"Big Spring, TX",36349,Micropolitan Statistical Area,AAPI,9,8,1,No meaningful results,,,,70,6,76
42500,"Scottsburg, IN",23759,Micropolitan Statistical Area,Black,0,0,0,No meaningful results,,,,57,8,65
42500,"Scottsburg, IN",23759,Micropolitan Statistical Area,Latino,0,0,0,No meaningful results,,,,57,8,65
42500,"Scottsburg, IN",23759,Micropolitan Statistical Area,Native American,0,0,0,No meaningful results,,,,57,8,65
42500,"Scottsburg, IN",23759,Micropolitan Statistical Area,AAPI,1,1,0,No meaningful results,,,,57,8,65
37300,"Palestine, TX",57810,Micropolitan Statistical Area,Black,11,9,2,No meaningful results,,,,119,17,136
37300,"Palestine, TX",57810,Micropolitan Statistical Area,Latino,24,16,8,No meaningful results,,,,119,17,136
37300,"Palestine, TX",57810,Micropolitan Statistical Area,Native American,2,2,0,No meaningful results,,,,119,17,136
37300,"Palestine, TX",57810,Micropolitan Statistical Area,AAPI,6,5,1,No meaningful results,,,,119,17,136
38380,"Plainview, TX",33826,Micropolitan Statistical Area,Black,1,1,0,No meaningful results,,,,48,4,52
38380,"Plainview, TX",33826,Micropolitan Statistical Area,Latino,31,25,6,No meaningful results,,,,48,4,52
38380,"Plainview, TX",33826,Micropolitan Statistical Area,Native American,1,0,1,No meaningful results,,,,48,4,52
38380,"Plainview, TX",33826,Micropolitan Statistical Area,AAPI,0,0,0,No meaningful results,,,,48,4,52
29500,"Lamesa, TX",12813,Micropolitan Statistical Area,Black,0,0,0,No meaningful results,,,,16,0,16
29500,"Lamesa, TX",12813,Micropolitan Statistical Area,Latino,9,7,2,No meaningful results,,,,16,0,16
29500,"Lamesa, TX",12813,Micropolitan Statistical Area,Native American,0,0,0,No meaningful results,,,,16,0,16
29500,"Lamesa, TX",12813,Micropolitan Statistical Area,AAPI,0,0,0,No meaningful results,,,,16,0,16
43660,"Snyder, TX",17096,Micropolitan Statistical Area,Black,0,0,0,No meaningful results,,,,35,3,38
43660,"Snyder, TX",17096,Micropolitan Statistical Area,Latino,9,8,1,No meaningful results,,,,35,3,38
43660,"Snyder, TX",17096,Micropolitan Statistical Area,Native American,0,0,0,No meaningful results,,,,35,3,38
43660,"Snyder, TX",17096,Micropolitan Statistical Area,AAPI,1,1,0,No meaningful results,,,,35,3,38
31620,"Magnolia, AR",23776,Micropolitan Statistical Area,Black,8,6,2,No meaningful results,,,,62,2,64
31620,"Magnolia, AR",23776,Micropolitan Statistical Area,Latino,4,4,0,No meaningful results,,,,62,2,64
31620,"Magnolia, AR",23776,Micropolitan Statistical Area,Native American,0,0,0,No meaningful results,,,,62,2,64
31620,"Magnolia, AR",23776,Micropolitan Statistical Area,AAPI,0,0,0,No meaningful results,,,,62,2,64
47980,"Watertown, SD",34051,Micropolitan Statistical Area,Black,0,0,0,No meaningful results,,,,205,7,212
47980,"Watertown, SD",34051,Micropolitan Statistical Area,Latino,4,4,0,No meaningful results,,,,205,7,212
47980,"Watertown, SD",34051,Micropolitan Statistical Area,Native American,0,0,0,No meaningful results,,,,205,7,212
47980,"Watertown, SD",34051,Micropolitan Statistical Area,AAPI,1,1,0,No meaningful results,,,,205,7,212
39660,"Rapid City, SD",138402,Metropolitan Statistical Area,Black,2,2,0,No meaningful results,,,,721,34,755
39660,"Rapid City, SD",138402,Metropolitan Statistical Area,Latino,16,15,1,No meaningful results,,,,721,34,755
39660,"Rapid City, SD",138402,Metropolitan Statistical Area,Native American,10,10,0,No meaningful results,,,,721,34,755
39660,"Rapid City, SD",138402,Metropolitan Statistical Area,AAPI,20,19,1,No meaningful results,,,,721,34,755
44660,"Stillwater, OK",81815,Micropolitan Statistical Area,Black,3,3,0,No meaningful results,,,,270,9,279
44660,"Stillwater, OK",81815,Micropolitan Statistical Area,Latino,9,8,1,No meaningful results,,,,270,9,279
44660,"Stillwater, OK",81815,Micropolitan Statistical Area,Native American,18,16,2,No meaningful results,,,,270,9,279
44660,"Stillwater, OK",81815,Micropolitan Statistical Area,AAPI,12,12,0,No meaningful results,,,,270,9,279
32260,"Marshalltown, IA",39964,Micropolitan Statistical Area,Black,3,3,0,No meaningful results,,,,141,7,148
32260,"Marshalltown, IA",39964,Micropolitan Statistical Area,Latino,49,46,3,No meaningful results,,,,141,7,148
32260,"Marshalltown, IA",39964,Micropolitan Statistical Area,Native American,0,0,0,No meaningful results,,,,141,7,148
32260,"Marshalltown, IA",39964,Micropolitan Statistical Area,AAPI,14,12,2,No meaningful results,,,,141,7,148
25100,"Guymon, OK",20805,Micropolitan Statistical Area,Black,0,0,0,No meaningful results,,,,17,2,19
25100,"Guymon, OK",20805,Micropolitan Statistical Area,Latino,29,23,6,No meaningful results,,,,17,2,19
25100,"Guymon, OK",20805,Micropolitan Statistical Area,Native American,0,0,0,No meaningful results,,,,17,2,19
25100,"Guymon, OK",20805,Micropolitan Statistical Area,AAPI,1,1,0,No meaningful results,,,,17,2,19
38180,"Pierre, SD",20625,Micropolitan Statistical Area,Black,0,0,0,No meaningful results,,,,76,5,81
38180,"Pierre, SD",20625,Micropolitan Statistical Area,Latino,1,1,0,No meaningful results,,,,76,5,81
38180,"Pierre, SD",20625,Micropolitan Statistical Area,Native American,3,2,1,No meaningful results,,,,76,5,81
38180,"Pierre, SD",20625,Micropolitan Statistical Area,AAPI,0,0,0,No meaningful results,,,,76,5,81
23980,"Glasgow, KY",53920,Micropolitan Statistical Area,Black,5,5,0,No meaningful results,,,,211,15,226
23980,"Glasgow, KY",53920,Micropolitan Statistical Area,Latino,3,1,2,No meaningful results,,,,211,15,226
23980,"Glasgow, KY",53920,Micropolitan Statistical Area,Native American,0,0,0,No meaningful results,,,,211,15,226
23980,"Glasgow, KY",53920,Micropolitan Statistical Area,AAPI,3,3,0,No meaningful results,,,,211,15,226
19620,"Del Rio, TX",48969,Micropolitan Statistical Area,Black,0,0,0,No meaningful results,,,,19,1,20
19620,"Del Rio, TX",48969,Micropolitan Statistical Area,Latino,49,43,6,No meaningful results,,,,19,1,20
19620,"Del Rio, TX",48969,Micropolitan Statistical Area,Native American,0,0,0,No meaningful results,,,,19,1,20
19620,"Del Rio, TX",48969,Micropolitan Statistical Area,AAPI,1,1,0,No meaningful results,,,,19,1,20
23140,"Frankfort, IN",32273,Micropolitan Statistical Area,Black,0,0,0,No meaningful results,,,,142,12,154
23140,"Frankfort, IN",32273,Micropolitan Statistical Area,Latino,9,7,2,No meaningful results,,,,142,12,154
23140,"Frankfort, IN",32273,Micropolitan Statistical Area,Native American,0,0,0,No meaningful results,,,,142,12,154
23140,"Frankfort, IN",32273,Micropolitan Statistical Area,AAPI,0,0,0,No meaningful results,,,,142,12,154
10760,"Alexander City, AL",51298,Micropolitan Statistical Area,Black,4,4,0,No meaningful results,,,,140,7,147
10760,"Alexander City, AL",51298,Micropolitan Statistical Area,Latino,0,0,0,No meaningful results,,,,140,7,147
10760,"Alexander City, AL",51298,Micropolitan Statistical Area,Native American,0,0,0,No meaningful results,,,,140,7,147
10760,"Alexander City, AL",51298,Micropolitan Statistical Area,AAPI,3,3,0,No meaningful results,,,,140,7,147
29900,"Laurinburg, NC",35076,Micropolitan Statistical Area,Black,14,11,3,No meaningful results,,,,38,9,47
29900,"Laurinburg, NC",35076,Micropolitan Statistical Area,Latino,1,1,0,No meaningful results,,,,38,9,47
29900,"Laurinburg, NC",35076,Micropolitan Statistical Area,Native American,5,4,1,No meaningful results,,,,38,9,47
29900,"Laurinburg, NC",35076,Micropolitan Statistical Area,AAPI,1,1,0,No meaningful results,,,,38,9,47
27530,"Jasper, AL",64110,Micropolitan Statistical Area,Black,5,3,2,No meaningful results,,,,167,16,183
27530,"Jasper, AL",64110,Micropolitan Statistical Area,Latino,2,1,1,No meaningful results,,,,167,16,183
27530,"Jasper, AL",64110,Micropolitan Statistical Area,Native American,0,0,0,No meaningful results,,,,167,16,183
27530,"Jasper, AL",64110,Micropolitan Statistical Area,AAPI,2,2,0,No meaningful results,,,,167,16,183
19220,"Danville, KY",54448,Micropolitan Statistical Area,Black,4,3,1,No meaningful results,,,,171,14,185
19220,"Danville, KY",54448,Micropolitan Statistical Area,Latino,2,1,1,No meaningful results,,,,171,14,185
19220,"Danville, KY",54448,Micropolitan Statistical Area,Native American,2,2,0,No meaningful results,,,,171,14,185
19220,"Danville, KY",54448,Micropolitan Statistical Area,AAPI,3,3,0,No meaningful results,,,,171,14,185
38920,"Port Lavaca, TX",21668,Micropolitan Statistical Area,Black,0,0,0,No meaningful results,,,,33,1,34
38920,"Port Lavaca, TX",21668,Micropolitan Statistical Area,Latino,12,8,4,No meaningful results,,,,33,1,34
38920,"Port Lavaca, TX",21668,Micropolitan Statistical Area,Native American,0,0,0,No meaningful results,,,,33,1,34
38920,"Port Lavaca, TX",21668,Micropolitan Statistical Area,AAPI,0,0,0,No meaningful results,,,,33,1,34
49260,"Woodward, OK",24742,Micropolitan Statistical Area,Black,0,0,0,No meaningful results,,,,81,0,81
49260,"Woodward, OK",24742,Micropolitan Statistical Area,Latino,2,2,0,No meaningful results,,,,81,0,81
49260,"Woodward, OK",24742,Micropolitan Statistical Area,Native American,0,0,0,No meaningful results,,,,81,0,81
49260,"Woodward, OK",24742,Micropolitan Statistical Area,AAPI,0,0,0,No meaningful results,,,,81,0,81
36820,"Oskaloosa, IA",22164,Micropolitan Statistical Area,Black,1,1,0,No meaningful results,,,,131,14,145
36820,"Oskaloosa, IA",22164,Micropolitan Statistical Area,Latino,1,1,0,No meaningful results,,,,131,14,145
36820,"Oskaloosa, IA",22164,Micropolitan Statistical Area,Native American,2,2,0,No meaningful results,,,,131,14,145
36820,"Oskaloosa, IA",22164,Micropolitan Statistical Area,AAPI,1,1,0,No meaningful results,,,,131,14,145
35580,"New Ulm, MN",25163,Micropolitan Statistical Area,Black,0,0,0,No meaningful results,,,,91,3,94
35580,"New Ulm, MN",25163,Micropolitan Statistical Area,Latino,3,3,0,No meaningful results,,,,91,3,94
35580,"New Ulm, MN",25163,Micropolitan Statistical Area,Native American,0,0,0,No meaningful results,,,,91,3,94
35580,"New Ulm, MN",25163,Micropolitan Statistical Area,AAPI,0,0,0,No meaningful results,,,,91,3,94
24820,"Greenville, OH",51513,Micropolitan Statistical Area,Black,1,1,0,No meaningful results,,,,129,16,145
24820,"Greenville, OH",51513,Micropolitan Statistical Area,Latino,1,1,0,No meaningful results,,,,129,16,145
24820,"Greenville, OH",51513,Micropolitan Statistical Area,Native American,0,0,0,No meaningful results,,,,129,16,145
24820,"Greenville, OH",51513,Micropolitan Statistical Area,AAPI,2,2,0,No meaningful results,,,,129,16,145
30420,"Lexington, NE",25746,Micropolitan Statistical Area,Black,1,1,0,No meaningful results,,,,54,2,56
30420,"Lexington, NE",25746,Micropolitan Statistical Area,Latino,15,13,2,No meaningful results,,,,54,2,56
30420,"Lexington, NE",25746,Micropolitan Statistical Area,Native American,1,1,0,No meaningful results,,,,54,2,56
30420,"Lexington, NE",25746,Micropolitan Statistical Area,AAPI,2,2,0,No meaningful results,,,,54,2,56
12980,"Battle Creek, MI",134212,Metropolitan Statistical Area,Black,37,35,2,Regression equation needs to be tweaked,0.09460116,0.1,1,745,41,786
12980,"Battle Creek, MI",134212,Metropolitan Statistical Area,Latino,18,17,1,Regression equation needs to be tweaked,0.967677078,1,10,745,41,786
12980,"Battle Creek, MI",134212,Metropolitan Statistical Area,Native American,9,6,3,Regression equation needs to be tweaked,11.28083026,11.3,113,745,41,786
12980,"Battle Creek, MI",134212,Metropolitan Statistical Area,AAPI,51,50,1,Regression equation needs to be tweaked,0.307940356,0.3,3,745,41,786
32540,"McAlester, OK",44146,Micropolitan Statistical Area,Black,1,1,0,No meaningful results,,,,91,4,95
32540,"McAlester, OK",44146,Micropolitan Statistical Area,Latino,5,3,2,No meaningful results,,,,91,4,95
32540,"McAlester, OK",44146,Micropolitan Statistical Area,Native American,8,6,2,No meaningful results,,,,91,4,95
32540,"McAlester, OK",44146,Micropolitan Statistical Area,AAPI,3,3,0,No meaningful results,,,,91,4,95
45020,"Sweetwater, TX",14904,Micropolitan Statistical Area,Black,1,1,0,No meaningful results,,,,32,3,35
45020,"Sweetwater, TX",14904,Micropolitan Statistical Area,Latino,9,9,0,No meaningful results,,,,32,3,35
45020,"Sweetwater, TX",14904,Micropolitan Statistical Area,Native American,0,0,0,No meaningful results,,,,32,3,35
45020,"Sweetwater, TX",14904,Micropolitan Statistical Area,AAPI,0,0,0,No meaningful results,,,,32,3,35
37940,"Peru, IN",35815,Micropolitan Statistical Area,Black,1,1,0,No meaningful results,,,,93,6,99
37940,"Peru, IN",35815,Micropolitan Statistical Area,Latino,2,1,1,No meaningful results,,,,93,6,99
37940,"Peru, IN",35815,Micropolitan Statistical Area,Native American,0,0,0,No meaningful results,,,,93,6,99
37940,"Peru, IN",35815,Micropolitan Statistical Area,AAPI,0,0,0,No meaningful results,,,,93,6,99
19860,"Dickinson, ND",32003,Micropolitan Statistical Area,Black,1,1,0,No meaningful results,,,,168,7,175
19860,"Dickinson, ND",32003,Micropolitan Statistical Area,Latino,3,3,0,No meaningful results,,,,168,7,175
19860,"Dickinson, ND",32003,Micropolitan Statistical Area,Native American,1,1,0,No meaningful results,,,,168,7,175
19860,"Dickinson, ND",32003,Micropolitan Statistical Area,AAPI,1,1,0,No meaningful results,,,,168,7,175
30820,"Lock Haven, PA",38915,Micropolitan Statistical Area,Black,0,0,0,No meaningful results,,,,134,11,145
30820,"Lock Haven, PA",38915,Micropolitan Statistical Area,Latino,2,2,0,No meaningful results,,,,134,11,145
30820,"Lock Haven, PA",38915,Micropolitan Statistical Area,Native American,0,0,0,No meaningful results,,,,134,11,145
30820,"Lock Haven, PA",38915,Micropolitan Statistical Area,AAPI,3,2,1,No meaningful results,,,,134,11,145
24740,"Greenville, MS",46057,Micropolitan Statistical Area,Black,45,19,26,No meaningful results,,,,36,4,40
24740,"Greenville, MS",46057,Micropolitan Statistical Area,Latino,7,6,1,No meaningful results,,,,36,4,40
24740,"Greenville, MS",46057,Micropolitan Statistical Area,Native American,0,0,0,No meaningful results,,,,36,4,40
24740,"Greenville, MS",46057,Micropolitan Statistical Area,AAPI,2,2,0,No meaningful results,,,,36,4,40
20340,"Duncan, OK",43647,Micropolitan Statistical Area,Black,0,0,0,No meaningful results,,,,95,10,105
20340,"Duncan, OK",43647,Micropolitan Statistical Area,Latino,6,4,2,No meaningful results,,,,95,10,105
20340,"Duncan, OK",43647,Micropolitan Statistical Area,Native American,8,6,2,No meaningful results,,,,95,10,105
20340,"Duncan, OK",43647,Micropolitan Statistical Area,AAPI,2,2,0,No meaningful results,,,,95,10,105
48180,"Waycross, GA",54843,Micropolitan Statistical Area,Black,6,4,2,No meaningful results,,,,101,4,105
48180,"Waycross, GA",54843,Micropolitan Statistical Area,Latino,5,5,0,No meaningful results,,,,101,4,105
48180,"Waycross, GA",54843,Micropolitan Statistical Area,Native American,0,0,0,No meaningful results,,,,101,4,105
48180,"Waycross, GA",54843,Micropolitan Statistical Area,AAPI,1,1,0,No meaningful results,,,,101,4,105
43380,"Sidney, OH",48749,Micropolitan Statistical Area,Black,0,0,0,No meaningful results,,,,180,9,189
43380,"Sidney, OH",48749,Micropolitan Statistical Area,Latino,3,2,1,No meaningful results,,,,180,9,189
43380,"Sidney, OH",48749,Micropolitan Statistical Area,Native American,0,0,0,No meaningful results,,,,180,9,189
43380,"Sidney, OH",48749,Micropolitan Statistical Area,AAPI,2,2,0,No meaningful results,,,,180,9,189
42780,"Selinsgrove, PA",40483,Micropolitan Statistical Area,Black,1,1,0,No meaningful results,,,,60,7,67
42780,"Selinsgrove, PA",40483,Micropolitan Statistical Area,Latino,2,2,0,No meaningful results,,,,60,7,67
42780,"Selinsgrove, PA",40483,Micropolitan Statistical Area,Native American,0,0,0,No meaningful results,,,,60,7,67
42780,"Selinsgrove, PA",40483,Micropolitan Statistical Area,AAPI,2,2,0,No meaningful results,,,,60,7,67
28540,"Ketchikan, AK",13800,Micropolitan Statistical Area,Black,0,0,0,No meaningful results,,,,17,1,18
28540,"Ketchikan, AK",13800,Micropolitan Statistical Area,Latino,0,0,0,No meaningful results,,,,17,1,18
28540,"Ketchikan, AK",13800,Micropolitan Statistical Area,Native American,8,8,0,No meaningful results,,,,17,1,18
28540,"Ketchikan, AK",13800,Micropolitan Statistical Area,AAPI,1,1,0,No meaningful results,,,,17,1,18
40540,"Rock Springs, WY",43521,Micropolitan Statistical Area,Black,1,1,0,No meaningful results,,,,196,8,204
40540,"Rock Springs, WY",43521,Micropolitan Statistical Area,Latino,12,11,1,No meaningful results,,,,196,8,204
40540,"Rock Springs, WY",43521,Micropolitan Statistical Area,Native American,1,1,0,No meaningful results,,,,196,8,204
40540,"Rock Springs, WY",43521,Micropolitan Statistical Area,AAPI,2,2,0,No meaningful results,,,,196,8,204
21900,"Fairmont, WV",56355,Micropolitan Statistical Area,Black,0,0,0,No meaningful results,,,,206,16,222
21900,"Fairmont, WV",56355,Micropolitan Statistical Area,Latino,1,1,0,No meaningful results,,,,206,16,222
21900,"Fairmont, WV",56355,Micropolitan Statistical Area,Native American,0,0,0,No meaningful results,,,,206,16,222
21900,"Fairmont, WV",56355,Micropolitan Statistical Area,AAPI,2,2,0,No meaningful results,,,,206,16,222
34350,"Mount Gay-Shamrock, WV",33154,Micropolitan Statistical Area,Black,0,0,0,No meaningful results,,,,49,14,63
34350,"Mount Gay-Shamrock, WV",33154,Micropolitan Statistical Area,Latino,2,1,1,No meaningful results,,,,49,14,63
34350,"Mount Gay-Shamrock, WV",33154,Micropolitan Statistical Area,Native American,0,0,0,No meaningful results,,,,49,14,63
34350,"Mount Gay-Shamrock, WV",33154,Micropolitan Statistical Area,AAPI,0,0,0,No meaningful results,,,,49,14,63
10380,"Aguadilla-Isabela, PR",301107,Metropolitan Statistical Area,Black,0,0,0,No meaningful results,,,,10,5,15
10380,"Aguadilla-Isabela, PR",301107,Metropolitan Statistical Area,Latino,109,92,17,No meaningful results,,,,10,5,15
10380,"Aguadilla-Isabela, PR",301107,Metropolitan Statistical Area,Native American,1,1,0,No meaningful results,,,,10,5,15
10380,"Aguadilla-Isabela, PR",301107,Metropolitan Statistical Area,AAPI,0,0,0,No meaningful results,,,,10,5,15
32420,"Mayagüez, PR",99545,Metropolitan Statistical Area,Black,0,0,0,No meaningful results,,,,3,0,3
32420,"Mayagüez, PR",99545,Metropolitan Statistical Area,Latino,36,30,6,No meaningful results,,,,3,0,3
32420,"Mayagüez, PR",99545,Metropolitan Statistical Area,Native American,0,0,0,No meaningful results,,,,3,0,3
32420,"Mayagüez, PR",99545,Metropolitan Statistical Area,AAPI,0,0,0,No meaningful results,,,,3,0,3
11640,"Arecibo, PR",180567,Metropolitan Statistical Area,Black,0,0,0,No meaningful results,,,,1,0,1
11640,"Arecibo, PR",180567,Metropolitan Statistical Area,Latino,60,49,11,No meaningful results,,,,1,0,1
11640,"Arecibo, PR",180567,Metropolitan Statistical Area,Native American,0,0,0,No meaningful results,,,,1,0,1
11640,"Arecibo, PR",180567,Metropolitan Statistical Area,AAPI,0,0,0,No meaningful results,,,,1,0,1
41900,"San Germán, PR",125324,Metropolitan Statistical Area,Black,0,0,0,No meaningful results,,,,1,0,1
41900,"San Germán, PR",125324,Metropolitan Statistical Area,Latino,74,62,12,No meaningful results,,,,1,0,1
41900,"San Germán, PR",125324,Metropolitan Statistical Area,Native American,0,0,0,No meaningful results,,,,1,0,1
41900,"San Germán, PR",125324,Metropolitan Statistical Area,AAPI,0,0,0,No meaningful results,,,,1,0,1
38660,"Ponce, PR",226117,Metropolitan Statistical Area,Black,1,0,1,No meaningful results,,,,1,0,1
38660,"Ponce, PR",226117,Metropolitan Statistical Area,Latino,107,87,20,No meaningful results,,,,1,0,1
38660,"Ponce, PR",226117,Metropolitan Statistical Area,Native American,0,0,0,No meaningful results,,,,1,0,1
38660,"Ponce, PR",226117,Metropolitan Statistical Area,AAPI,0,0,0,No meaningful results,,,,1,0,1
25020,"Guayama, PR",75623,Metropolitan Statistical Area,Black,0,0,0,No meaningful results,,,,1,0,1
25020,"Guayama, PR",75623,Metropolitan Statistical Area,Latino,25,19,6,No meaningful results,,,,1,0,1
25020,"Guayama, PR",75623,Metropolitan Statistical Area,Native American,0,0,0,No meaningful results,,,,1,0,1
25020,"Guayama, PR",75623,Metropolitan Statistical Area,AAPI,0,0,0,No meaningful results,,,,1,0,1
49500,"Yauco, PR",90618,Metropolitan Statistical Area,Black,0,0,0,No meaningful results,,,,1,0,1
49500,"Yauco, PR",90618,Metropolitan Statistical Area,Latino,19,15,4,No meaningful results,,,,1,0,1
49500,"Yauco, PR",90618,Metropolitan Statistical Area,Native American,0,0,0,No meaningful results,,,,1,0,1
49500,"Yauco, PR",90618,Metropolitan Statistical Area,AAPI,0,0,0,No meaningful results,,,,1,0,1
42180,"Santa Isabel, PR",21757,Micropolitan Statistical Area,Black,0,0,0,No meaningful results,,,,0,0,0
42180,"Santa Isabel, PR",21757,Micropolitan Statistical Area,Latino,6,5,1,No meaningful results,,,,0,0,0
42180,"Santa Isabel, PR",21757,Micropolitan Statistical Area,Native American,0,0,0,No meaningful results,,,,0,0,0
42180,"Santa Isabel, PR",21757,Micropolitan Statistical Area,AAPI,0,0,0,No meaningful results,,,,0,0,0
17620,"Coamo, PR",38906,Micropolitan Statistical Area,Black,0,0,0,No meaningful results,,,,1,0,1
17620,"Coamo, PR",38906,Micropolitan Statistical Area,Latino,4,3,1,No meaningful results,,,,1,0,1
17620,"Coamo, PR",38906,Micropolitan Statistical Area,Native American,0,0,0,No meaningful results,,,,1,0,1
17620,"Coamo, PR",38906,Micropolitan Statistical Area,AAPI,0,0,0,No meaningful results,,,,1,0,1
33580,"Mitchell, SD",23270,Micropolitan Statistical Area,Black,2,1,1,No meaningful results,,,,109,6,115
33580,"Mitchell, SD",23270,Micropolitan Statistical Area,Latino,2,1,1,No meaningful results,,,,109,6,115
33580,"Mitchell, SD",23270,Micropolitan Statistical Area,Native American,1,0,1,No meaningful results,,,,109,6,115
33580,"Mitchell, SD",23270,Micropolitan Statistical Area,AAPI,0,0,0,No meaningful results,,,,109,6,115
14220,"Bogalusa, LA",46435,Micropolitan Statistical Area,Black,3,2,1,No meaningful results,,,,34,5,39
14220,"Bogalusa, LA",46435,Micropolitan Statistical Area,Latino,1,0,1,No meaningful results,,,,34,5,39
14220,"Bogalusa, LA",46435,Micropolitan Statistical Area,Native American,0,0,0,No meaningful results,,,,34,5,39
14220,"Bogalusa, LA",46435,Micropolitan Statistical Area,AAPI,0,0,0,No meaningful results,,,,34,5,39
43060,"Shawnee, OK",72154,Micropolitan Statistical Area,Black,0,0,0,No meaningful results,,,,164,11,175
43060,"Shawnee, OK",72154,Micropolitan Statistical Area,Latino,14,13,1,No meaningful results,,,,164,11,175
43060,"Shawnee, OK",72154,Micropolitan Statistical Area,Native American,13,12,1,No meaningful results,,,,164,11,175
43060,"Shawnee, OK",72154,Micropolitan Statistical Area,AAPI,1,1,0,No meaningful results,,,,164,11,175
35060,"Natchitoches, LA",38769,Micropolitan Statistical Area,Black,10,5,5,No meaningful results,,,,53,5,58
35060,"Natchitoches, LA",38769,Micropolitan Statistical Area,Latino,1,1,0,No meaningful results,,,,53,5,58
35060,"Natchitoches, LA",38769,Micropolitan Statistical Area,Native American,1,1,0,No meaningful results,,,,53,5,58
35060,"Natchitoches, LA",38769,Micropolitan Statistical Area,AAPI,4,3,1,No meaningful results,,,,53,5,58
30260,"Lewisburg, PA",45111,Micropolitan Statistical Area,Black,3,3,0,No meaningful results,,,,104,5,109
30260,"Lewisburg, PA",45111,Micropolitan Statistical Area,Latino,3,3,0,No meaningful results,,,,104,5,109
30260,"Lewisburg, PA",45111,Micropolitan Statistical Area,Native American,1,1,0,No meaningful results,,,,104,5,109
30260,"Lewisburg, PA",45111,Micropolitan Statistical Area,AAPI,4,4,0,No meaningful results,,,,104,5,109
20580,"Eagle Pass, TX",58174,Micropolitan Statistical Area,Black,1,1,0,No meaningful results,,,,6,0,6
20580,"Eagle Pass, TX",58174,Micropolitan Statistical Area,Latino,60,53,7,No meaningful results,,,,6,0,6
20580,"Eagle Pass, TX",58174,Micropolitan Statistical Area,Native American,1,1,0,No meaningful results,,,,6,0,6
20580,"Eagle Pass, TX",58174,Micropolitan Statistical Area,AAPI,0,0,0,No meaningful results,,,,6,0,6
45140,"Tahlequah, OK",48664,Micropolitan Statistical Area,Black,1,1,0,No meaningful results,,,,75,6,81
45140,"Tahlequah, OK",48664,Micropolitan Statistical Area,Latino,7,5,2,No meaningful results,,,,75,6,81
45140,"Tahlequah, OK",48664,Micropolitan Statistical Area,Native American,28,26,2,No meaningful results,,,,75,6,81
45140,"Tahlequah, OK",48664,Micropolitan Statistical Area,AAPI,2,2,0,No meaningful results,,,,75,6,81
20820,"Effingham, IL",34137,Micropolitan Statistical Area,Black,0,0,0,No meaningful results,,,,158,7,165
20820,"Effingham, IL",34137,Micropolitan Statistical Area,Latino,2,2,0,No meaningful results,,,,158,7,165
20820,"Effingham, IL",34137,Micropolitan Statistical Area,Native American,0,0,0,No meaningful results,,,,158,7,165
20820,"Effingham, IL",34137,Micropolitan Statistical Area,AAPI,0,0,0,No meaningful results,,,,158,7,165
31500,"Madison, IN",32201,Micropolitan Statistical Area,Black,0,0,0,No meaningful results,,,,160,7,167
31500,"Madison, IN",32201,Micropolitan Statistical Area,Latino,1,1,0,No meaningful results,,,,160,7,167
31500,"Madison, IN",32201,Micropolitan Statistical Area,Native American,0,0,0,No meaningful results,,,,160,7,167
31500,"Madison, IN",32201,Micropolitan Statistical Area,AAPI,7,6,1,No meaningful results,,,,160,7,167
27540,"Jasper, IN",54921,Micropolitan Statistical Area,Black,0,0,0,No meaningful results,,,,218,11,229
27540,"Jasper, IN",54921,Micropolitan Statistical Area,Latino,13,11,2,No meaningful results,,,,218,11,229
27540,"Jasper, IN",54921,Micropolitan Statistical Area,Native American,0,0,0,No meaningful results,,,,218,11,229
27540,"Jasper, IN",54921,Micropolitan Statistical Area,AAPI,1,0,1,No meaningful results,,,,218,11,229
37780,"Pecos, TX",15590,Micropolitan Statistical Area,Black,0,0,0,No meaningful results,,,,3,0,3
37780,"Pecos, TX",15590,Micropolitan Statistical Area,Latino,8,4,4,No meaningful results,,,,3,0,3
37780,"Pecos, TX",15590,Micropolitan Statistical Area,Native American,0,0,0,No meaningful results,,,,3,0,3
37780,"Pecos, TX",15590,Micropolitan Statistical Area,AAPI,3,3,0,No meaningful results,,,,3,0,3
48220,"Weatherford, OK",29152,Micropolitan Statistical Area,Black,2,2,0,No meaningful results,,,,59,5,64
48220,"Weatherford, OK",29152,Micropolitan Statistical Area,Latino,10,7,3,No meaningful results,,,,59,5,64
48220,"Weatherford, OK",29152,Micropolitan Statistical Area,Native American,4,4,0,No meaningful results,,,,59,5,64
48220,"Weatherford, OK",29152,Micropolitan Statistical Area,AAPI,2,2,0,No meaningful results,,,,59,5,64
44940,"Sumter, SC",140714,Metropolitan Statistical Area,Black,48,39,9,No meaningful results,,,,247,18,265
44940,"Sumter, SC",140714,Metropolitan Statistical Area,Latino,10,10,0,No meaningful results,,,,247,18,265
44940,"Sumter, SC",140714,Metropolitan Statistical Area,Native American,3,3,0,No meaningful results,,,,247,18,265
44940,"Sumter, SC",140714,Metropolitan Statistical Area,AAPI,5,4,1,No meaningful results,,,,247,18,265
25780,"Henderson, NC",44479,Micropolitan Statistical Area,Black,30,22,8,No meaningful results,,,,65,5,70
25780,"Henderson, NC",44479,Micropolitan Statistical Area,Latino,7,5,2,No meaningful results,,,,65,5,70
25780,"Henderson, NC",44479,Micropolitan Statistical Area,Native American,0,0,0,No meaningful results,,,,65,5,70
25780,"Henderson, NC",44479,Micropolitan Statistical Area,AAPI,1,1,0,No meaningful results,,,,65,5,70
11660,"Arkadelphia, AR",22386,Micropolitan Statistical Area,Black,4,3,1,No meaningful results,,,,43,5,48
11660,"Arkadelphia, AR",22386,Micropolitan Statistical Area,Latino,3,3,0,No meaningful results,,,,43,5,48
11660,"Arkadelphia, AR",22386,Micropolitan Statistical Area,Native American,0,0,0,No meaningful results,,,,43,5,48
11660,"Arkadelphia, AR",22386,Micropolitan Statistical Area,AAPI,1,1,0,No meaningful results,,,,43,5,48
32180,"Marshall, MO",22976,Micropolitan Statistical Area,Black,0,0,0,No meaningful results,,,,24,2,26
32180,"Marshall, MO",22976,Micropolitan Statistical Area,Latino,13,13,0,No meaningful results,,,,24,2,26
32180,"Marshall, MO",22976,Micropolitan Statistical Area,Native American,0,0,0,No meaningful results,,,,24,2,26
32180,"Marshall, MO",22976,Micropolitan Statistical Area,AAPI,1,1,0,No meaningful results,,,,24,2,26
35900,"North Wilkesboro, NC",68469,Micropolitan Statistical Area,Black,3,3,0,No meaningful results,,,,241,22,263
35900,"North Wilkesboro, NC",68469,Micropolitan Statistical Area,Latino,12,12,0,No meaningful results,,,,241,22,263
35900,"North Wilkesboro, NC",68469,Micropolitan Statistical Area,Native American,0,0,0,No meaningful results,,,,241,22,263
35900,"North Wilkesboro, NC",68469,Micropolitan Statistical Area,AAPI,2,2,0,No meaningful results,,,,241,22,263
40260,"Roanoke Rapids, NC",71136,Micropolitan Statistical Area,Black,29,26,3,No meaningful results,,,,90,9,99
40260,"Roanoke Rapids, NC",71136,Micropolitan Statistical Area,Latino,2,1,1,No meaningful results,,,,90,9,99
40260,"Roanoke Rapids, NC",71136,Micropolitan Statistical Area,Native American,0,0,0,No meaningful results,,,,90,9,99
40260,"Roanoke Rapids, NC",71136,Micropolitan Statistical Area,AAPI,0,0,0,No meaningful results,,,,90,9,99
15620,"Cadillac, MI",48284,Micropolitan Statistical Area,Black,0,0,0,No meaningful results,,,,211,23,234
15620,"Cadillac, MI",48284,Micropolitan Statistical Area,Latino,5,4,1,No meaningful results,,,,211,23,234
15620,"Cadillac, MI",48284,Micropolitan Statistical Area,Native American,3,2,1,No meaningful results,,,,211,23,234
15620,"Cadillac, MI",48284,Micropolitan Statistical Area,AAPI,1,1,0,No meaningful results,,,,211,23,234
39060,"Pottsville, PA",142674,Micropolitan Statistical Area,Black,0,0,0,No meaningful results,,,,410,40,450
39060,"Pottsville, PA",142674,Micropolitan Statistical Area,Latino,22,18,4,No meaningful results,,,,410,40,450
39060,"Pottsville, PA",142674,Micropolitan Statistical Area,Native American,0,0,0,No meaningful results,,,,410,40,450
39060,"Pottsville, PA",142674,Micropolitan Statistical Area,AAPI,5,4,1,No meaningful results,,,,410,40,450
44980,"Sunbury, PA",91761,Micropolitan Statistical Area,Black,2,2,0,No meaningful results,,,,198,19,217
44980,"Sunbury, PA",91761,Micropolitan Statistical Area,Latino,7,5,2,No meaningful results,,,,198,19,217
44980,"Sunbury, PA",91761,Micropolitan Statistical Area,Native American,1,1,0,No meaningful results,,,,198,19,217
44980,"Sunbury, PA",91761,Micropolitan Statistical Area,AAPI,7,7,0,No meaningful results,,,,198,19,217
36700,"Orangeburg, SC",87687,Micropolitan Statistical Area,Black,40,32,8,No meaningful results,,,,101,11,112
36700,"Orangeburg, SC",87687,Micropolitan Statistical Area,Latino,5,4,1,No meaningful results,,,,101,11,112
36700,"Orangeburg, SC",87687,Micropolitan Statistical Area,Native American,3,3,0,No meaningful results,,,,101,11,112
36700,"Orangeburg, SC",87687,Micropolitan Statistical Area,AAPI,4,4,0,No meaningful results,,,,101,11,112
33060,"Miami, OK",31454,Micropolitan Statistical Area,Black,0,0,0,No meaningful results,,,,35,6,41
33060,"Miami, OK",31454,Micropolitan Statistical Area,Latino,0,0,0,No meaningful results,,,,35,6,41
33060,"Miami, OK",31454,Micropolitan Statistical Area,Native American,8,7,1,No meaningful results,,,,35,6,41
33060,"Miami, OK",31454,Micropolitan Statistical Area,AAPI,3,2,1,No meaningful results,,,,35,6,41
34780,"Muskogee, OK",68736,Micropolitan Statistical Area,Black,10,6,4,No meaningful results,,,,123,11,134
34780,"Muskogee, OK",68736,Micropolitan Statistical Area,Latino,10,10,0,No meaningful results,,,,123,11,134
34780,"Muskogee, OK",68736,Micropolitan Statistical Area,Native American,43,41,2,No meaningful results,,,,123,11,134
34780,"Muskogee, OK",68736,Micropolitan Statistical Area,AAPI,3,3,0,No meaningful results,,,,123,11,134
11060,"Altus, OK",25063,Micropolitan Statistical Area,Black,0,0,0,No meaningful results,,,,37,5,42
11060,"Altus, OK",25063,Micropolitan Statistical Area,Latino,3,3,0,No meaningful results,,,,37,5,42
11060,"Altus, OK",25063,Micropolitan Statistical Area,Native American,1,1,0,No meaningful results,,,,37,5,42
11060,"Altus, OK",25063,Micropolitan Statistical Area,AAPI,5,5,0,No meaningful results,,,,37,5,42
34460,"Mount Sterling, KY",46682,Micropolitan Statistical Area,Black,2,2,0,No meaningful results,,,,134,9,143
34460,"Mount Sterling, KY",46682,Micropolitan Statistical Area,Latino,2,1,1,No meaningful results,,,,134,9,143
34460,"Mount Sterling, KY",46682,Micropolitan Statistical Area,Native American,0,0,0,No meaningful results,,,,134,9,143
34460,"Mount Sterling, KY",46682,Micropolitan Statistical Area,AAPI,2,2,0,No meaningful results,,,,134,9,143
28380,"Kennett, MO",30027,Micropolitan Statistical Area,Black,1,1,0,No meaningful results,,,,26,3,29
28380,"Kennett, MO",30027,Micropolitan Statistical Area,Latino,2,1,1,No meaningful results,,,,26,3,29
28380,"Kennett, MO",30027,Micropolitan Statistical Area,Native American,0,0,0,No meaningful results,,,,26,3,29
28380,"Kennett, MO",30027,Micropolitan Statistical Area,AAPI,1,1,0,No meaningful results,,,,26,3,29
32460,"Mayfield, KY",37248,Micropolitan Statistical Area,Black,1,1,0,No meaningful results,,,,67,5,72
32460,"Mayfield, KY",37248,Micropolitan Statistical Area,Latino,5,5,0,No meaningful results,,,,67,5,72
32460,"Mayfield, KY",37248,Micropolitan Statistical Area,Native American,1,1,0,No meaningful results,,,,67,5,72
32460,"Mayfield, KY",37248,Micropolitan Statistical Area,AAPI,1,1,0,No meaningful results,,,,67,5,72
15820,"Campbellsville, KY",36550,Micropolitan Statistical Area,Black,2,2,0,No meaningful results,,,,85,14,99
15820,"Campbellsville, KY",36550,Micropolitan Statistical Area,Latino,3,3,0,No meaningful results,,,,85,14,99
15820,"Campbellsville, KY",36550,Micropolitan Statistical Area,Native American,1,0,1,No meaningful results,,,,85,14,99
15820,"Campbellsville, KY",36550,Micropolitan Statistical Area,AAPI,1,1,0,No meaningful results,,,,85,14,99
17380,"Cleveland, MS",31848,Micropolitan Statistical Area,Black,10,8,2,No meaningful results,,,,52,5,57
17380,"Cleveland, MS",31848,Micropolitan Statistical Area,Latino,2,2,0,No meaningful results,,,,52,5,57
17380,"Cleveland, MS",31848,Micropolitan Statistical Area,Native American,0,0,0,No meaningful results,,,,52,5,57
17380,"Cleveland, MS",31848,Micropolitan Statistical Area,AAPI,2,2,0,No meaningful results,,,,52,5,57
48500,"West Point, MS",19640,Micropolitan Statistical Area,Black,6,4,2,No meaningful results,,,,16,2,18
48500,"West Point, MS",19640,Micropolitan Statistical Area,Latino,0,0,0,No meaningful results,,,,16,2,18
48500,"West Point, MS",19640,Micropolitan Statistical Area,Native American,0,0,0,No meaningful results,,,,16,2,18
48500,"West Point, MS",19640,Micropolitan Statistical Area,AAPI,0,0,0,No meaningful results,,,,16,2,18
46460,"Union City, TN",30365,Micropolitan Statistical Area,Black,0,0,0,No meaningful results,,,,67,11,78
46460,"Union City, TN",30365,Micropolitan Statistical Area,Latino,7,5,2,No meaningful results,,,,67,11,78
46460,"Union City, TN",30365,Micropolitan Statistical Area,Native American,0,0,0,No meaningful results,,,,67,11,78
46460,"Union City, TN",30365,Micropolitan Statistical Area,AAPI,1,1,0,No meaningful results,,,,67,11,78
18500,"Corning, NY",96422,Micropolitan Statistical Area,Black,6,5,1,No meaningful results,,,,374,29,403
18500,"Corning, NY",96422,Micropolitan Statistical Area,Latino,6,5,1,No meaningful results,,,,374,29,403
18500,"Corning, NY",96422,Micropolitan Statistical Area,Native American,4,3,1,No meaningful results,,,,374,29,403
18500,"Corning, NY",96422,Micropolitan Statistical Area,AAPI,32,30,2,No meaningful results,,,,374,29,403
42900,"Seneca Falls, NY",34390,Micropolitan Statistical Area,Black,0,0,0,No meaningful results,,,,115,9,124
42900,"Seneca Falls, NY",34390,Micropolitan Statistical Area,Latino,0,0,0,No meaningful results,,,,115,9,124
42900,"Seneca Falls, NY",34390,Micropolitan Statistical Area,Native American,0,0,0,No meaningful results,,,,115,9,124
42900,"Seneca Falls, NY",34390,Micropolitan Statistical Area,AAPI,4,4,0,No meaningful results,,,,115,9,124
14620,"Bradford, PA",41401,Micropolitan Statistical Area,Black,1,0,1,No meaningful results,,,,99,20,119
14620,"Bradford, PA",41401,Micropolitan Statistical Area,Latino,2,2,0,No meaningful results,,,,99,20,119
14620,"Bradford, PA",41401,Micropolitan Statistical Area,Native American,0,0,0,No meaningful results,,,,99,20,119
14620,"Bradford, PA",41401,Micropolitan Statistical Area,AAPI,1,1,0,No meaningful results,,,,99,20,119
18220,"Connersville, IN",23194,Micropolitan Statistical Area,Black,0,0,0,No meaningful results,,,,57,7,64
18220,"Connersville, IN",23194,Micropolitan Statistical Area,Latino,1,0,1,No meaningful results,,,,57,7,64
18220,"Connersville, IN",23194,Micropolitan Statistical Area,Native American,0,0,0,No meaningful results,,,,57,7,64
18220,"Connersville, IN",23194,Micropolitan Statistical Area,AAPI,0,0,0,No meaningful results,,,,57,7,64
46780,"Van Wert, OH",28261,Micropolitan Statistical Area,Black,2,2,0,No meaningful results,,,,100,12,112
46780,"Van Wert, OH",28261,Micropolitan Statistical Area,Latino,4,3,1,No meaningful results,,,,100,12,112
46780,"Van Wert, OH",28261,Micropolitan Statistical Area,Native American,0,0,0,No meaningful results,,,,100,12,112
46780,"Van Wert, OH",28261,Micropolitan Statistical Area,AAPI,1,1,0,No meaningful results,,,,100,12,112
24700,"Greensburg, IN",26562,Micropolitan Statistical Area,Black,0,0,0,No meaningful results,,,,123,2,125
24700,"Greensburg, IN",26562,Micropolitan Statistical Area,Latino,1,1,0,No meaningful results,,,,123,2,125
24700,"Greensburg, IN",26562,Micropolitan Statistical Area,Native American,0,0,0,No meaningful results,,,,123,2,125
24700,"Greensburg, IN",26562,Micropolitan Statistical Area,AAPI,0,0,0,No meaningful results,,,,123,2,125
47180,"Vincennes, IN",37065,Micropolitan Statistical Area,Black,1,1,0,No meaningful results,,,,121,12,133
47180,"Vincennes, IN",37065,Micropolitan Statistical Area,Latino,2,1,1,No meaningful results,,,,121,12,133
47180,"Vincennes, IN",37065,Micropolitan Statistical Area,Native American,0,0,0,No meaningful results,,,,121,12,133
47180,"Vincennes, IN",37065,Micropolitan Statistical Area,AAPI,2,2,0,No meaningful results,,,,121,12,133
11020,"Altoona, PA",123157,Metropolitan Statistical Area,Black,1,1,0,No meaningful results,,,,462,38,500
11020,"Altoona, PA",123157,Metropolitan Statistical Area,Latino,3,3,0,No meaningful results,,,,462,38,500
11020,"Altoona, PA",123157,Metropolitan Statistical Area,Native American,1,1,0,No meaningful results,,,,462,38,500
11020,"Altoona, PA",123157,Metropolitan Statistical Area,AAPI,9,9,0,No meaningful results,,,,462,38,500
18420,"Corinth, MS",37090,Micropolitan Statistical Area,Black,0,0,0,No meaningful results,,,,72,8,80
18420,"Corinth, MS",37090,Micropolitan Statistical Area,Latino,1,1,0,No meaningful results,,,,72,8,80
18420,"Corinth, MS",37090,Micropolitan Statistical Area,Native American,0,0,0,No meaningful results,,,,72,8,80
18420,"Corinth, MS",37090,Micropolitan Statistical Area,AAPI,1,1,0,No meaningful results,,,,72,8,80
26700,"Huron, SD",20364,Micropolitan Statistical Area,Black,0,0,0,No meaningful results,,,,19,3,22
26700,"Huron, SD",20364,Micropolitan Statistical Area,Latino,1,1,0,No meaningful results,,,,19,3,22
26700,"Huron, SD",20364,Micropolitan Statistical Area,Native American,0,0,0,No meaningful results,,,,19,3,22
26700,"Huron, SD",20364,Micropolitan Statistical Area,AAPI,1,1,0,No meaningful results,,,,19,3,22
21540,"Escanaba, MI",36026,Micropolitan Statistical Area,Black,0,0,0,No meaningful results,,,,52,8,60
21540,"Escanaba, MI",36026,Micropolitan Statistical Area,Latino,0,0,0,No meaningful results,,,,52,8,60
21540,"Escanaba, MI",36026,Micropolitan Statistical Area,Native American,4,3,1,No meaningful results,,,,52,8,60
21540,"Escanaba, MI",36026,Micropolitan Statistical Area,AAPI,1,0,1,No meaningful results,,,,52,8,60
34020,"Morgan City, LA",50968,Micropolitan Statistical Area,Black,2,2,0,No meaningful results,,,,67,4,71
34020,"Morgan City, LA",50968,Micropolitan Statistical Area,Latino,4,2,2,No meaningful results,,,,67,4,71
34020,"Morgan City, LA",50968,Micropolitan Statistical Area,Native American,2,2,0,No meaningful results,,,,67,4,71
34020,"Morgan City, LA",50968,Micropolitan Statistical Area,AAPI,1,1,0,No meaningful results,,,,67,4,71
27700,"Jesup, GA",29788,Micropolitan Statistical Area,Black,2,2,0,No meaningful results,,,,42,1,43
27700,"Jesup, GA",29788,Micropolitan Statistical Area,Latino,1,1,0,No meaningful results,,,,42,1,43
27700,"Jesup, GA",29788,Micropolitan Statistical Area,Native American,0,0,0,No meaningful results,,,,42,1,43
27700,"Jesup, GA",29788,Micropolitan Statistical Area,AAPI,0,0,0,No meaningful results,,,,42,1,43
17500,"Clewiston, FL",40732,Micropolitan Statistical Area,Black,4,4,0,No meaningful results,,,,43,5,48
17500,"Clewiston, FL",40732,Micropolitan Statistical Area,Latino,44,34,10,No meaningful results,,,,43,5,48
17500,"Clewiston, FL",40732,Micropolitan Statistical Area,Native American,0,0,0,No meaningful results,,,,43,5,48
17500,"Clewiston, FL",40732,Micropolitan Statistical Area,AAPI,2,2,0,No meaningful results,,,,43,5,48
36380,"Okeechobee, FL",41144,Micropolitan Statistical Area,Black,0,0,0,No meaningful results,,,,72,9,81
36380,"Okeechobee, FL",41144,Micropolitan Statistical Area,Latino,26,22,4,No meaningful results,,,,72,9,81
36380,"Okeechobee, FL",41144,Micropolitan Statistical Area,Native American,2,2,0,No meaningful results,,,,72,9,81
36380,"Okeechobee, FL",41144,Micropolitan Statistical Area,AAPI,1,1,0,No meaningful results,,,,72,9,81
17260,"Clarksdale, MS",23255,Micropolitan Statistical Area,Black,1,0,1,No meaningful results,,,,11,2,13
17260,"Clarksdale, MS",23255,Micropolitan Statistical Area,Latino,0,0,0,No meaningful results,,,,11,2,13
17260,"Clarksdale, MS",23255,Micropolitan Statistical Area,Native American,0,0,0,No meaningful results,,,,11,2,13
17260,"Clarksdale, MS",23255,Micropolitan Statistical Area,AAPI,2,2,0,No meaningful results,,,,11,2,13
10100,"Aberdeen, SD",42824,Micropolitan Statistical Area,Black,1,1,0,No meaningful results,,,,172,11,183
10100,"Aberdeen, SD",42824,Micropolitan Statistical Area,Latino,4,3,1,No meaningful results,,,,172,11,183
10100,"Aberdeen, SD",42824,Micropolitan Statistical Area,Native American,2,2,0,No meaningful results,,,,172,11,183
10100,"Aberdeen, SD",42824,Micropolitan Statistical Area,AAPI,9,6,3,No meaningful results,,,,172,11,183
37800,"Pella, IA",33172,Micropolitan Statistical Area,Black,0,0,0,No meaningful results,,,,236,16,252
37800,"Pella, IA",33172,Micropolitan Statistical Area,Latino,3,2,1,No meaningful results,,,,236,16,252
37800,"Pella, IA",33172,Micropolitan Statistical Area,Native American,1,1,0,No meaningful results,,,,236,16,252
37800,"Pella, IA",33172,Micropolitan Statistical Area,AAPI,4,3,1,No meaningful results,,,,236,16,252
48460,"West Plains, MO",40104,Micropolitan Statistical Area,Black,0,0,0,No meaningful results,,,,108,8,116
48460,"West Plains, MO",40104,Micropolitan Statistical Area,Latino,5,4,1,No meaningful results,,,,108,8,116
48460,"West Plains, MO",40104,Micropolitan Statistical Area,Native American,3,2,1,No meaningful results,,,,108,8,116
48460,"West Plains, MO",40104,Micropolitan Statistical Area,AAPI,0,0,0,No meaningful results,,,,108,8,116
16660,"Charleston-Mattoon, IL",62189,Micropolitan Statistical Area,Black,1,1,0,No meaningful results,,,,141,17,158
16660,"Charleston-Mattoon, IL",62189,Micropolitan Statistical Area,Latino,4,4,0,No meaningful results,,,,141,17,158
16660,"Charleston-Mattoon, IL",62189,Micropolitan Statistical Area,Native American,0,0,0,No meaningful results,,,,141,17,158
16660,"Charleston-Mattoon, IL",62189,Micropolitan Statistical Area,AAPI,2,2,0,No meaningful results,,,,141,17,158
27160,"Jackson, OH",32450,Micropolitan Statistical Area,Black,0,0,0,No meaningful results,,,,91,19,110
27160,"Jackson, OH",32450,Micropolitan Statistical Area,Latino,1,1,0,No meaningful results,,,,91,19,110
27160,"Jackson, OH",32450,Micropolitan Statistical Area,Native American,1,1,0,No meaningful results,,,,91,19,110
27160,"Jackson, OH",32450,Micropolitan Statistical Area,AAPI,0,0,0,No meaningful results,,,,91,19,110
34220,"Moultrie, GA",45486,Micropolitan Statistical Area,Black,3,3,0,No meaningful results,,,,36,3,39
34220,"Moultrie, GA",45486,Micropolitan Statistical Area,Latino,6,4,2,No meaningful results,,,,36,3,39
34220,"Moultrie, GA",45486,Micropolitan Statistical Area,Native American,0,0,0,No meaningful results,,,,36,3,39
34220,"Moultrie, GA",45486,Micropolitan Statistical Area,AAPI,3,3,0,No meaningful results,,,,36,3,39
13260,"Bedford, IN",45548,Micropolitan Statistical Area,Black,0,0,0,No meaningful results,,,,160,12,172
13260,"Bedford, IN",45548,Micropolitan Statistical Area,Latino,3,3,0,No meaningful results,,,,160,12,172
13260,"Bedford, IN",45548,Micropolitan Statistical Area,Native American,1,1,0,No meaningful results,,,,160,12,172
13260,"Bedford, IN",45548,Micropolitan Statistical Area,AAPI,1,1,0,No meaningful results,,,,160,12,172
18740,"Coshocton, OH",36585,Micropolitan Statistical Area,Black,2,1,1,No meaningful results,,,,114,13,127
18740,"Coshocton, OH",36585,Micropolitan Statistical Area,Latino,0,0,0,No meaningful results,,,,114,13,127
18740,"Coshocton, OH",36585,Micropolitan Statistical Area,Native American,2,2,0,No meaningful results,,,,114,13,127
18740,"Coshocton, OH",36585,Micropolitan Statistical Area,AAPI,0,0,0,No meaningful results,,,,114,13,127
22340,"Fitzgerald, GA",17033,Micropolitan Statistical Area,Black,1,1,0,No meaningful results,,,,12,0,12
22340,"Fitzgerald, GA",17033,Micropolitan Statistical Area,Latino,0,0,0,No meaningful results,,,,12,0,12
22340,"Fitzgerald, GA",17033,Micropolitan Statistical Area,Native American,0,0,0,No meaningful results,,,,12,0,12
22340,"Fitzgerald, GA",17033,Micropolitan Statistical Area,AAPI,3,2,1,No meaningful results,,,,12,0,12
23500,"Gaffney, SC",56895,Micropolitan Statistical Area,Black,15,9,6,No meaningful results,,,,122,12,134
23500,"Gaffney, SC",56895,Micropolitan Statistical Area,Latino,4,4,0,No meaningful results,,,,122,12,134
23500,"Gaffney, SC",56895,Micropolitan Statistical Area,Native American,0,0,0,No meaningful results,,,,122,12,134
23500,"Gaffney, SC",56895,Micropolitan Statistical Area,AAPI,0,0,0,No meaningful results,,,,122,12,134
42820,"Selma, AL",39149,Micropolitan Statistical Area,Black,11,8,3,No meaningful results,,,,16,2,18
42820,"Selma, AL",39149,Micropolitan Statistical Area,Latino,1,1,0,No meaningful results,,,,16,2,18
42820,"Selma, AL",39149,Micropolitan Statistical Area,Native American,0,0,0,No meaningful results,,,,16,2,18
42820,"Selma, AL",39149,Micropolitan Statistical Area,AAPI,0,0,0,No meaningful results,,,,16,2,18
32620,"McComb, MS",39532,Micropolitan Statistical Area,Black,9,7,2,No meaningful results,,,,37,4,41
32620,"McComb, MS",39532,Micropolitan Statistical Area,Latino,0,0,0,No meaningful results,,,,37,4,41
32620,"McComb, MS",39532,Micropolitan Statistical Area,Native American,0,0,0,No meaningful results,,,,37,4,41
32620,"McComb, MS",39532,Micropolitan Statistical Area,AAPI,0,0,0,No meaningful results,,,,37,4,41
32280,"Martin, TN",33510,Micropolitan Statistical Area,Black,2,1,1,No meaningful results,,,,73,11,84
32280,"Martin, TN",33510,Micropolitan Statistical Area,Latino,2,2,0,No meaningful results,,,,73,11,84
32280,"Martin, TN",33510,Micropolitan Statistical Area,Native American,0,0,0,No meaningful results,,,,73,11,84
32280,"Martin, TN",33510,Micropolitan Statistical Area,AAPI,1,1,0,No meaningful results,,,,73,11,84
26260,"Hope, AR",30193,Micropolitan Statistical Area,Black,9,4,5,No meaningful results,,,,27,6,33
26260,"Hope, AR",30193,Micropolitan Statistical Area,Latino,16,12,4,No meaningful results,,,,27,6,33
26260,"Hope, AR",30193,Micropolitan Statistical Area,Native American,0,0,0,No meaningful results,,,,27,6,33
26260,"Hope, AR",30193,Micropolitan Statistical Area,AAPI,0,0,0,No meaningful results,,,,27,6,33
19760,"DeRidder, LA",37043,Micropolitan Statistical Area,Black,2,2,0,No meaningful results,,,,79,6,85
19760,"DeRidder, LA",37043,Micropolitan Statistical Area,Latino,6,6,0,No meaningful results,,,,79,6,85
19760,"DeRidder, LA",37043,Micropolitan Statistical Area,Native American,0,0,0,No meaningful results,,,,79,6,85
19760,"DeRidder, LA",37043,Micropolitan Statistical Area,AAPI,1,1,0,No meaningful results,,,,79,6,85
28780,"Kingsville, TX",31542,Micropolitan Statistical Area,Black,2,2,0,No meaningful results,,,,19,1,20
28780,"Kingsville, TX",31542,Micropolitan Statistical Area,Latino,39,35,4,No meaningful results,,,,19,1,20
28780,"Kingsville, TX",31542,Micropolitan Statistical Area,Native American,1,1,0,No meaningful results,,,,19,1,20
28780,"Kingsville, TX",31542,Micropolitan Statistical Area,AAPI,5,5,0,No meaningful results,,,,19,1,20
38580,"Point Pleasant, WV-OH",56908,Micropolitan Statistical Area,Black,1,1,0,No meaningful results,,,,123,22,145
38580,"Point Pleasant, WV-OH",56908,Micropolitan Statistical Area,Latino,2,2,0,No meaningful results,,,,123,22,145
38580,"Point Pleasant, WV-OH",56908,Micropolitan Statistical Area,Native American,0,0,0,No meaningful results,,,,123,22,145
38580,"Point Pleasant, WV-OH",56908,Micropolitan Statistical Area,AAPI,0,0,0,No meaningful results,,,,123,22,145
35020,"Natchez, MS-LA",51044,Micropolitan Statistical Area,Black,14,12,2,No meaningful results,,,,41,4,45
35020,"Natchez, MS-LA",51044,Micropolitan Statistical Area,Latino,2,1,1,No meaningful results,,,,41,4,45
35020,"Natchez, MS-LA",51044,Micropolitan Statistical Area,Native American,1,1,0,No meaningful results,,,,41,4,45
35020,"Natchez, MS-LA",51044,Micropolitan Statistical Area,AAPI,1,1,0,No meaningful results,,,,41,4,45
21120,"Elk City, OK",22268,Micropolitan Statistical Area,Black,0,0,0,No meaningful results,,,,49,3,52
21120,"Elk City, OK",22268,Micropolitan Statistical Area,Latino,2,2,0,No meaningful results,,,,49,3,52
21120,"Elk City, OK",22268,Micropolitan Statistical Area,Native American,0,0,0,No meaningful results,,,,49,3,52
21120,"Elk City, OK",22268,Micropolitan Statistical Area,AAPI,0,0,0,No meaningful results,,,,49,3,52
21180,"Elkins, WV",28930,Micropolitan Statistical Area,Black,0,0,0,No meaningful results,,,,34,0,34
21180,"Elkins, WV",28930,Micropolitan Statistical Area,Latino,0,0,0,No meaningful results,,,,34,0,34
21180,"Elkins, WV",28930,Micropolitan Statistical Area,Native American,0,0,0,No meaningful results,,,,34,0,34
21180,"Elkins, WV",28930,Micropolitan Statistical Area,AAPI,0,0,0,No meaningful results,,,,34,0,34
49820,"Zapata, TX",14304,Micropolitan Statistical Area,Black,0,0,0,No meaningful results,,,,0,0,0
49820,"Zapata, TX",14304,Micropolitan Statistical Area,Latino,4,3,1,No meaningful results,,,,0,0,0
49820,"Zapata, TX",14304,Micropolitan Statistical Area,Native American,0,0,0,No meaningful results,,,,0,0,0
49820,"Zapata, TX",14304,Micropolitan Statistical Area,AAPI,0,0,0,No meaningful results,,,,0,0,0
37770,"Pearsall, TX",19871,Micropolitan Statistical Area,Black,0,0,0,No meaningful results,,,,7,1,8
37770,"Pearsall, TX",19871,Micropolitan Statistical Area,Latino,9,8,1,No meaningful results,,,,7,1,8
37770,"Pearsall, TX",19871,Micropolitan Statistical Area,Native American,0,0,0,No meaningful results,,,,7,1,8
37770,"Pearsall, TX",19871,Micropolitan Statistical Area,AAPI,0,0,0,No meaningful results,,,,7,1,8
33500,"Minot, ND",77132,Micropolitan Statistical Area,Black,0,0,0,No meaningful results,,,,314,4,318
33500,"Minot, ND",77132,Micropolitan Statistical Area,Latino,8,8,0,No meaningful results,,,,314,4,318
33500,"Minot, ND",77132,Micropolitan Statistical Area,Native American,2,2,0,No meaningful results,,,,314,4,318
33500,"Minot, ND",77132,Micropolitan Statistical Area,AAPI,1,0,1,No meaningful results,,,,314,4,318
11140,"Americus, GA",35285,Micropolitan Statistical Area,Black,7,7,0,No meaningful results,,,,44,2,46
11140,"Americus, GA",35285,Micropolitan Statistical Area,Latino,5,4,1,No meaningful results,,,,44,2,46
11140,"Americus, GA",35285,Micropolitan Statistical Area,Native American,0,0,0,No meaningful results,,,,44,2,46
11140,"Americus, GA",35285,Micropolitan Statistical Area,AAPI,3,3,0,No meaningful results,,,,44,2,46
21640,"Eufaula, AL-GA",27650,Micropolitan Statistical Area,Black,5,4,1,No meaningful results,,,,32,3,35
21640,"Eufaula, AL-GA",27650,Micropolitan Statistical Area,Latino,0,0,0,No meaningful results,,,,32,3,35
21640,"Eufaula, AL-GA",27650,Micropolitan Statistical Area,Native American,0,0,0,No meaningful results,,,,32,3,35
21640,"Eufaula, AL-GA",27650,Micropolitan Statistical Area,AAPI,0,0,0,No meaningful results,,,,32,3,35
47780,"Washington, IN",33120,Micropolitan Statistical Area,Black,1,0,1,No meaningful results,,,,71,8,79
47780,"Washington, IN",33120,Micropolitan Statistical Area,Latino,5,4,1,No meaningful results,,,,71,8,79
47780,"Washington, IN",33120,Micropolitan Statistical Area,Native American,0,0,0,No meaningful results,,,,71,8,79
47780,"Washington, IN",33120,Micropolitan Statistical Area,AAPI,0,0,0,No meaningful results,,,,71,8,79
22860,"Fort Polk South, LA",49646,Micropolitan Statistical Area,Black,2,2,0,No meaningful results,,,,47,7,54
22860,"Fort Polk South, LA",49646,Micropolitan Statistical Area,Latino,3,3,0,No meaningful results,,,,47,7,54
22860,"Fort Polk South, LA",49646,Micropolitan Statistical Area,Native American,1,1,0,No meaningful results,,,,47,7,54
22860,"Fort Polk South, LA",49646,Micropolitan Statistical Area,AAPI,3,3,0,No meaningful results,,,,47,7,54
32500,"Maysville, KY",17112,Micropolitan Statistical Area,Black,0,0,0,No meaningful results,,,,42,9,51
32500,"Maysville, KY",17112,Micropolitan Statistical Area,Latino,0,0,0,No meaningful results,,,,42,9,51
32500,"Maysville, KY",17112,Micropolitan Statistical Area,Native American,0,0,0,No meaningful results,,,,42,9,51
32500,"Maysville, KY",17112,Micropolitan Statistical Area,AAPI,0,0,0,No meaningful results,,,,42,9,51
42300,"Sault Ste. Marie, MI",37629,Micropolitan Statistical Area,Black,0,0,0,No meaningful results,,,,26,5,31
42300,"Sault Ste. Marie, MI",37629,Micropolitan Statistical Area,Latino,1,0,1,No meaningful results,,,,26,5,31
42300,"Sault Ste. Marie, MI",37629,Micropolitan Statistical Area,Native American,9,8,1,No meaningful results,,,,26,5,31
42300,"Sault Ste. Marie, MI",37629,Micropolitan Statistical Area,AAPI,1,0,1,No meaningful results,,,,26,5,31
25820,"Hereford, TX",18736,Micropolitan Statistical Area,Black,0,0,0,No meaningful results,,,,12,0,12
25820,"Hereford, TX",18736,Micropolitan Statistical Area,Latino,14,12,2,No meaningful results,,,,12,0,12
25820,"Hereford, TX",18736,Micropolitan Statistical Area,Native American,0,0,0,No meaningful results,,,,12,0,12
25820,"Hereford, TX",18736,Micropolitan Statistical Area,AAPI,1,1,0,No meaningful results,,,,12,0,12
20060,"Douglas, GA",51260,Micropolitan Statistical Area,Black,4,4,0,No meaningful results,,,,48,5,53
20060,"Douglas, GA",51260,Micropolitan Statistical Area,Latino,3,3,0,No meaningful results,,,,48,5,53
20060,"Douglas, GA",51260,Micropolitan Statistical Area,Native American,0,0,0,No meaningful results,,,,48,5,53
20060,"Douglas, GA",51260,Micropolitan Statistical Area,AAPI,0,0,0,No meaningful results,,,,48,5,53
11580,"Arcadia, FL",36903,Micropolitan Statistical Area,Black,6,5,1,No meaningful results,,,,69,11,80
11580,"Arcadia, FL",36903,Micropolitan Statistical Area,Latino,16,15,1,No meaningful results,,,,69,11,80
11580,"Arcadia, FL",36903,Micropolitan Statistical Area,Native American,1,1,0,No meaningful results,,,,69,11,80
11580,"Arcadia, FL",36903,Micropolitan Statistical Area,AAPI,0,0,0,No meaningful results,,,,69,11,80
21860,"Fairmont, MN",19852,Micropolitan Statistical Area,Black,0,0,0,No meaningful results,,,,93,15,108
21860,"Fairmont, MN",19852,Micropolitan Statistical Area,Latino,3,3,0,No meaningful results,,,,93,15,108
21860,"Fairmont, MN",19852,Micropolitan Statistical Area,Native American,0,0,0,No meaningful results,,,,93,15,108
21860,"Fairmont, MN",19852,Micropolitan Statistical Area,AAPI,2,2,0,No meaningful results,,,,93,15,108
48100,"Wauchula, FL",27131,Micropolitan Statistical Area,Black,5,1,4,No meaningful results,,,,26,1,27
48100,"Wauchula, FL",27131,Micropolitan Statistical Area,Latino,8,7,1,No meaningful results,,,,26,1,27
48100,"Wauchula, FL",27131,Micropolitan Statistical Area,Native American,0,0,0,No meaningful results,,,,26,1,27
48100,"Wauchula, FL",27131,Micropolitan Statistical Area,AAPI,1,1,0,No meaningful results,,,,26,1,27
13500,"Bennettsville, SC",26753,Micropolitan Statistical Area,Black,11,7,4,No meaningful results,,,,9,5,14
13500,"Bennettsville, SC",26753,Micropolitan Statistical Area,Latino,1,1,0,No meaningful results,,,,9,5,14
13500,"Bennettsville, SC",26753,Micropolitan Statistical Area,Native American,1,0,1,No meaningful results,,,,9,5,14
13500,"Bennettsville, SC",26753,Micropolitan Statistical Area,AAPI,0,0,0,No meaningful results,,,,9,5,14
17640,"Coco, PR",28109,Micropolitan Statistical Area,Black,0,0,0,No meaningful results,,,,0,0,0
17640,"Coco, PR",28109,Micropolitan Statistical Area,Latino,3,1,2,No meaningful results,,,,0,0,0
17640,"Coco, PR",28109,Micropolitan Statistical Area,Native American,0,0,0,No meaningful results,,,,0,0,0
17640,"Coco, PR",28109,Micropolitan Statistical Area,AAPI,0,0,0,No meaningful results,,,,0,0,0
27580,"Jayuya, PR",14539,Micropolitan Statistical Area,Black,0,0,0,No meaningful results,,,,0,0,0
27580,"Jayuya, PR",14539,Micropolitan Statistical Area,Latino,1,0,1,No meaningful results,,,,0,0,0
27580,"Jayuya, PR",14539,Micropolitan Statistical Area,Native American,0,0,0,No meaningful results,,,,0,0,0
27580,"Jayuya, PR",14539,Micropolitan Statistical Area,AAPI,0,0,0,No meaningful results,,,,0,0,0
,National,,Country,Black,,90219,13560,Statistcially significant disparity,1.816525,1.8,18,1528127,85880,1614007
,National,,Country,Latino,,206353,22903,Statistcially significant disparity,1.448402,1.4,14,1528127,85880,1614007
,National,,Country,Native American,,8021,891,Statistcially significant disparity,1.662053,1.7,17,1528127,85880,1614007
,National,,Country,AAPI,,183138,16774,Statistcially significant disparity,1.471445,1.5,15,1528127,85880,1614007